marit		marry
ri	Verb	?
rib	Determiner	adjz
laik	Noun	desire
mumragar	Noun	face
aŋ	Verb	2sg.ipst,2sg
kupu		inside
rekodim		record
twitwi	Noun	bird.sp
yambar	Noun	story
kɨb	Noun	road
kwiriŋ	Noun	back
brou	Noun	frog
sagɨ	Noun	fight
aragur	Noun	riverbank
taŋɨr umbaŋ	Noun	tree.sp
ogi	Verb	3pl.ds
ika		father.1.poss
wanbel	Noun	unity
kɨtɨŋ		far
kwi	Adverb	back
meŋ	Noun	shoulder
tu	Verb	burn
nɨrɨb	Pronoun	3pl.emph
dua	Noun	door
w	Verb	go
Joachim	ProperNoun	Joachim
kobey	Verb	cook
renona	Noun	landowner
kare	Noun	betelnut
arame	Noun	tree.sp
megwar	Noun	bowstring
ayo	Noun	plant.sp
anɨgunuŋ	Pronoun	1pl.obj
i	Verb	get
pɨtɨ		wet
skul	Noun	school
kr	Verb	cook
agɨr	Noun	arrow
na	Determiner	nd
gekɨm	Noun	bug.sp
sakum	Noun	nape
tok	Noun	speech
at	Noun	hat
tɨbram	Verb	tie
Amerika	ProperNoun	America
kuk	Noun	kitchen
gwakɨr	Noun	tree.sp
sor	Noun	salt
is	Verb	bite
ram	Verb	do?
tibigi	Verb	spill
muku	Noun	ball
kwar	Noun	garden
mar		half
yabɨ	Pronoun	1sg.emph
kupuŋ	Noun	lime,dust
urunda		good
katig birou	Noun	snake.sp
mak	Verb	pick
ino	Particle	neg
abi	Noun	woman
mɨŋimbr	Verb	ruin
tub	Noun	tree.sp
abi kuŋar		girl
urua	Noun	pumpkin
arkem	Noun	k.o.knife
kɨbar	Noun	eel
kenɨ	Noun	elbow
pɨsɨ	Noun	smoke
stap	Verb	stay
beraŋ	Verb	2sg.fut
koyeb	Noun	bird.sp
kome	Noun	tree.sp
gunu	Adjective	dry
warinda		crooked
Takwar	ProperNoun	Takwar
kiŋakuŋ	Noun	wildfowl
yet	Particle	emph
tatar		bottom
sabar	Noun	yam
kram	Verb	burn
soŋ	Noun	arrow
kɨbur		cold
masna	Noun	friend
pulim		pull
mari		cousin
tɨbɨgi	Verb	pour.out
ibɨ	Noun	yam
greŋ		dry,black
uru	Noun	house
kwe	Particle	quot
ikakai	Verb	follow
gutpela	Adjective	good
igon	Verb	feed
peroŋberoŋ	Noun	bird.sp
Antonia	ProperNoun	Antonia
gariŋ	Noun	possum
kumu	Noun	stomach
kɨp	Verb	get.up
andu	Pronoun	1pl.poss
keŋɨm	Noun	worm.sp
isam		brother.1.poss
takw	Verb	cut,buy
Bege	ProperNoun	Bege
segwar	Verb	shoot
nagur	Noun	mosquito
mɨtat	Verb	leave
taŋɨr	Noun	fish.sp
stroŋim		strengthen
girum	Noun	eggshell
mogir		a.few.days.ago
kukum	Noun	bird.sp
ib	Noun	name
aŋɨrara		dream
kapr	Verb	throw
kobyaŋ	Noun	bamboo.sp
nɨrɨ	Pronoun	3pl
karo	Noun	tree.sp
kyaŋɨ	Noun	fish
gigira	Noun	corn
setim		set
beber	Noun	shoulderblade
sekir		3.days.after.today
sope	Verb	finish.ss
sisik	Noun	itch
mɨri	Verb	marry
korɨm	Noun	tree.sp
mɨŋat	Verb	get
amaŋ	Noun	seed
Dise	ProperNoun	Dise
goreg	Noun	tree.sp
prabsapu		again
nenaŋ	Noun	children
Utu	ProperNoun	Utu
ofis	Noun	office
pe	Noun	middle
rak		brother
sumuri	Verb	smell
o	Particle	or
unusi	Verb	bury
ubia	Noun	morning.star
sukur	Noun	intestine
mumu	Noun	nose,sharp
taun	Noun	town
murub	Noun	possum
kur	Verb	3sg.imp
ya	Interjection	here
due	Noun	grass.sp
makɨkob	Noun	ant.sp
tyag	Noun	tree.sp
dane	Noun	taro
maket	Noun	market
mateb	Verb	paddle
anoŋ	Noun	egg,baby
aŋ̃em	Noun	bug
kwait	Verb	return
maksaŋ	Noun	tree.sp
am	Verb	2sg.imp
ninar	Verb	perform
tar	Noun	tree
lain	Noun	group
ib	Determiner	advz
ware	Noun	mountain
sinoŋ	Noun	basket
yogr	Verb	complete
bɨniŋ	Postposition	near
Areic	ProperNoun	RH
aŋandam	Verb	hear
niaŋ	Noun	fruit
Simon	ProperNoun	Simon
kai	Noun	sugar
ku	Determiner	nom
iseŋke	Noun	snake.sp
kisag	Noun	ear
waik		come!
kubyaŋ	Noun	sweet.potato
nabɨ	Pronoun	2sg.emph
korɨmgorɨm	Noun	tree.sp
tuk	Verb	exhale,scrape,burn
gɨbam	Noun	ant.sp
agwi	Noun	fish.sp
ɨnda	Verb	2sg.ds
kur	Adverb	just
urakɨr	Adverb	night
mondɨŋ	Noun	k.o.stone
mɨk	Verb	peel
itu	Verb	pull
haus	Noun	house
gamɨgi	Noun	reed.sp
Moroni	ProperNoun	Moroni
yaŋgr	Verb	gather
iruŋsuriŋ	Noun	bird.sp
kɨtɨ	Verb	stay.ss
uh	Interjection	uh
tib	Noun	presence
kondɨ	Adverb	morning
aŋgɨn	Verb	sleep
aba	Particle	quot
mɨkɨr	Noun	drum,tree.sp
kwi	Noun	back
kastam	Noun	tradition
kar	Noun	car
kamaŋ	Noun	party
imoŋ	Noun	fish.sp
ageg	Noun	bird.sp
sɨgɨ	Noun	cockroach
sokou	Noun	bird.sp
morɨ	Noun	reed.sp
kogr	Verb	roast
umbaŋ	Noun	liver
ambro	Adverb	poorly
isɨŋ	Noun	air
sɨkr	Verb	pull
nug		deep
klen	Noun	clan
wayaŋ	Noun	sun
Kristina	ProperNoun	Christina
aŋ gyou	Noun	snake.sp
mukum		no.fire
koge	Noun	knee
sagwi	Noun	tongue
yambo	Noun	tree.sp
ituitu	Adverb	pulling
motig	Noun	other.side
Japan	ProperNoun	Japan
kubrotar	Noun	tree.sp
be	Particle	q
tirim		distribute
mobi		dirty
bigur		unripe
naŋgari	Adverb	now
we	Verb	come.ss
yakub		sorry
tasol	Particle	but
mɨke	Noun	bandicoot
gome	Noun	tree.sp
tokples	Noun	language
un	Verb	dig
maski	Adverb	nevermind
iro	Noun	hand.drum
arama	Interjection	nevermind
tiŋim		think
ŋ		yes
isapame	Verb	bite
awaŋgi	Noun	shrub.sp
atam	Adverb	alone
gir	Noun	time
tamɨ	Noun	eye
kr	Verb	walk
mabɨŋ		no
sore	Noun	bird.sp
kyag	Noun	tree.sp
aŋgeŋ	Noun	leg
mare soŋgrɨm	Noun	fish.sp
ambɨŋ	Noun	wing
apɨrapɨr	Noun	bee.sp
sigir	Noun	rind
Tekses	ProperNoun	Texas
umandum	Noun	giant
bes		base
Don	ProperNoun	Don
mai	Noun	friend
panpan	Noun	tree.sp,bat.sp
kabi		wife
merund	Verb	forget
tembr	Verb	turn
pɨnɨ	Noun	palm.sp
berɨ	Noun	firelight
Musak	ProperNoun	Musak,Musak.clan
seŋɨ	Noun	cultivated.pandanus
kɨnam	Noun	bottom
aŋ guraŋgi	Noun	snake.sp
kim	Noun	bow
sori		sorry
kriŋ	Postposition	li
maŋgima		many
gesa	Noun	mango
birou	Noun	snake.sp
baya	Noun	bamboo.sp
ukur	Noun	fish.sp
tage	Noun	shrub.sp
akrab	Noun	middle.of.road
makim		become
mɨŋapam	Verb	hold
ukre	Verb	blow
yame	Noun	crocodile
Jansen	ProperNoun	Junction
ayo	Interjection	oh
ese	Interjection	that's.right
sig	Noun	pot
yota	Interjection	yes
s	Verb	fpst
maŋ	Noun	banana
ket	Verb	2pl.imp
kya	Noun	song
tubu tukare	Verb	push.and.roll
wa	Verb	come
arɨ	Noun	hair
imbr	Verb	spoil
gumu		done?
mo	Quantifier	spec
stret	Adverb	exactly
amekam	Noun	lastborn
metam		high
ber	Verb	3sg.fut
makɨ	Noun	anger
ketab	Adverb	around
tagur	Verb	care.for,wait.for
Aba	ProperNoun	Aba
aŋgoŋ	Noun	hook
gor	Adjective	dear
itam	Verb	transport
bɨgri	Noun	stomach
kɨtɨ	Particle	and
ambɨt	Verb	be.sleepy
murumuru	Noun	shadow
tam	Verb	put
apapara	Noun	butterfly
beŋ	Noun	tree.sp
tumbuna	Noun	ancestor
tɨmbre	Verb	look
yagim	Noun	fish.sp
imbare	Noun	liar
agi	Interjection	alright
koye	Noun	tree.sp
las		last
kɨmɨŋ	Adverb	later
gagam	Noun	sweat
bib	Noun	fence
kampani	Noun	company
kɨr	Noun	body
o	Verb	2sg.imp
tɨk	Verb	take
Lesly	ProperNoun	Lesly
iksat		
pabra	Quantifier	one
de	Noun	day
mekoŋ	Noun	brains
kamapim		create
tokpisin	ProperNoun	Tok.Pisin
kando	Noun	fish.sp
am	Verb	do
aŋ doŋ	Noun	bandicoot.sp
poroman	Noun	friend
ma	Particle	neg
Medeŋ	ProperNoun	Madang
mɨŋmekar	Verb	turn.around
bar	Verb	3sg.ctrf
tokar	Verb	wash
taram	Noun	thigh
sabɨ	Noun	pig
gugur		4.days.after.today
Inaŋ	ProperNoun	Inaŋ
banɨ	Noun	spear
muŋgubr	Verb	break
gokɨr	Noun	bug.sp
go	Particle	?
yow	Verb	hit
iskat	Verb	leave
mɨŋ		tasty
ameki	Noun	lastborn
katiŋ	Postposition	li
peto		short
kɨsɨr	Noun	finger,seed
soŋgo	Noun	ant.sp
kinɨ kwatiŋ kwatiŋ	Noun	bug.sp
traim		try
sinami	Verb	smell
tugo	Noun	fish.sp
naŋ	Pronoun	2sg.obj
kɨsɨkɨ	Noun	meat
gigib	Noun	armpit
tum	Noun	stick
sab	Noun	work
meko	Noun	shrub.sp
waŋɨ	Noun	bag
kauntim		count
ab sɨkɨ		firewood
ipr	Verb	hide
katim		cut
ik	Verb	chop,cry
panda	Adverb	alone
dugum	Noun	forest
bɨni	Adverb	almost
dawaŋ	Noun	tree.sp
ab		temp
per	Verb	shine
pum	Noun	heavy
yarɨm	Noun	wallaby
mokɨr	Noun	whiteness
kroŋkroŋ	Noun	owl
piŋ	Noun	cheekbone
hatwara	Noun	hot.water
yosar	Verb	laugh
tendɨ	Noun	star,firefly
ab	Verb	talk
guŋ		thunder
sugu	Noun	cheek
korapsen	Noun	corruption
sanɨ	Noun	pig
yar	Noun	year
Kema	ProperNoun	firstborn
nabe		daughter.il
siksik	Noun	bird.sp
stat		start
noŋgut	Particle	lest
ŋ	Postposition	acc
kyarɨ	Noun	chicken
kasɨr	Noun	bamboo.sp
kar		sick
pinis	Adverb	finish,comp
eg	Verb	3sg.ds.frust
mesɨŋ	Noun	tree.sp
vilej kot	Noun	village.court
ram		aunt
gɨbiŋ	Adverb	still
goregbagusa	Noun	liver
kɨprɨŋ	Noun	bird.sp
magw	Verb	scatter
denɨ	Noun	toy.arrow
pes		first
niŋgikum		female
dɨgr	Verb	fall,remove
eg		?
Kuyab	ProperNoun	Sogeram
ayakayak	Noun	stuff
aboŋgapɨ	Noun	bird.sp
kareb	Noun	flying.fox
kinɨ	Noun	axe
igo	Particle	and.so.on
konɨ	Noun	hugeness
sinam	Noun	tree.sp
igam	Noun	blood
Maiker	ProperNoun	Michael
tuar	Verb	chop,say
og	Verb	3pl.ds.frust
komaŋ	Noun	branch
Tobias	ProperNoun	Tobias
kumbuke	Noun	cassowary
kɨrɨr	Noun	root
mɨrɨndandam	Noun	bug.sp
kikur	Noun	snake.sp
gor	Noun	cluster
ambɨ	Pronoun	1pl.emph
olgeta		all
kɨrɨra	Noun	arrow
ambɨr	Noun	bed
na	Pronoun	2sg
gir	Noun	ant
kamam	Noun	skirt
nuki	Verb	swallow
inventri	Noun	inventory
mɨneg	Adverb	after
be		nmlz
takɨ	Noun	vulva
gɨndɨ	Noun	noise
ti	Noun	tea
ra	Postposition	com
dogr	Verb	break
ta	Verb	ss.delay
urur	Noun	hole
tenpla		ten
itɨ	Verb	get.ss
dog	Verb	approach
histeri	Noun	history
paku	Noun	tree.sp
gwande	Noun	stone,money
Banam	ProperNoun	Banam
agrenda	Quantifier	two
krin		clear
yambar	Noun	snot
kuriŋ	Noun	calf
dager kapɨkapɨ	Noun	bird.sp
kosɨŋ	Noun	tree.sp
tɨŋ	Noun	news
bagɨr	Noun	side
tog	Verb	step.on
gɨgɨr		time
Yosep	ProperNoun	Joseph
Tabubir	ProperNoun	Tabubil
gabɨ	Noun	hornbill
kawaŋ	Noun	coconut
tipi	Verb	cock
igotar	Noun	tree.sp
mapɨŋ	Noun	sorrow
ayak	Noun	what
gɨnɨŋ	Postposition	gen
taim	Noun	time
miragar	Noun	face
mɨntag	Verb	take.out
uram	Verb	wash
sɨkɨ	Noun,Adjective	piece.of.wood,dry
kemɨkareb	Noun	tree.sp
meb	Postposition	like
tapɨrb	Verb	peel
agreŋ		two
kawob	Noun	tree.sp
gakuŋ		there
dɨkɨŋ	Noun	bird.sp
buŋ		meet
umiŋgɨgɨr	Adverb	afternoon
Albet	ProperNoun	Albert
kag		None
apɨr gyou	Noun	snake.sp
natɨ	Noun	crayfish
tubuimbɨre	Verb	push
dɨgam	Noun	tree.sp
akab		very
so	Particle	so
kɨŋ	Determiner	pauc
matɨm	Noun	mud
i	Verb	ss
maŋgi	Adjective	small
nogat	Interjection	no
mɨr	Noun	sap
anir		day.after.tomorrow
mɨŋe	Verb	answer
maripaŋ	Noun	k.o.arrow
korir	Noun	bird.sp
tr	Verb	fear
sɨrɨ	Noun	fat
naŋ	Noun	son
kum	Verb	die
yarɨm papayes		wallaby
kemaŋga	Noun	firstborn
ar	Verb	2pl.ipst,2pl
aŋ kuramba	Noun	bird.sp
pɨr	Noun	trunk
ikoŋ		uncle
kopr	Verb	run
Kris	ProperNoun	Chris
dibeg	Noun	shade
maŋgi	Noun	boy
manɨnɨŋ ke	Noun	tree.sp
leta	Noun	letter
kyagori		clean
sakre	Verb	look.after
kuru	Noun	man
mɨskat	Verb	leave
umuŋ	Noun	raincloud
pas	Noun	letter,closed
kogɨ		yellow
saŋɨr	Noun	centipede
niŋ	Determiner	loc
motab		some
kokr	Verb	swell.up
gunari	Noun	bird.sp
kaim	Noun	knife
noraŋ	Noun	children
pare	Verb	lie
muyaŋ		cassowary.call
sugum	Noun	tree.sp
re		prag
wanwik	Adverb	one.week
egi	Verb	3sg.ds
kaw	Verb	carry
aniriŋ		day.before.yesterday
kikiniŋ	Noun	jaw
umɨŋ		dark
irɨna	Noun	moon
ambandu	Pronoun	1pl.poss.emph
wat	Verb	vomit
sɨkɨb	Noun	bird.sp
kɨbɨr		wind
meri	Noun	woman
jayent	Noun	giant
ipram	Verb	hide
biruŋ	Verb	3pl.ctrf
kumob	Noun	arm
ya		1.poss
sesmik	Noun	seismic
Mosbi	ProperNoun	Moresby
sanɨ sɨkeb	Noun	bug.sp
ok	Verb	2sg.imp
sɨkaŋ	Adverb	totally
nor		daughter
kyambi	Noun	tree.sp
ya	Pronoun	1sg
sumboi	Noun	mouth
tapre	Verb	stand.up
ukugubr	Verb	shatter
kɨn	Verb	stay
gubr	Verb	break
ges	Noun	gas
koroŋ	Noun	pandanus
suku	Adverb	very
kamo	Noun	cloud
grar	Noun	pandanus
ume	Noun	bean
sepr	Verb	appear
sopayitɨ	Verb	finish.ss
lotu		worship
atiŋ	Particle	maybe
Dalas	ProperNoun	Dallas
stretim		fix
kren	Noun	clan
kwarɨ	Noun	tail
genaŋ	Adjective	dry
krig	Postposition	li
gabman	Noun	government
ayeb	Noun	uncle,child
geŋgoŋ		crooked
porer	Noun	shin
due kapɨkapɨ	Noun	bird.sp
umuŋkam	Noun	pandanus
gagaŋ	Noun	bird.sp
biri	Noun	tree.sp
si	Postposition	ben
wiwi	Noun	bird.sp
ninɨ	Pronoun	who
sɨb	Noun	village,mountaintop
marɨ	Noun	firewood
kapɨ	Noun	bird
olsem	Adverb	thus
sawar	Adverb	quickly
ik	Verb	2sg.imp
kakɨsiŋ		old
mɨmɨŋ	Adjective	small
mondemonde	Noun	lizard.sp
nɨgɨm	Noun	eel.sp
keb	Adverb	just
nɨbɨ	Pronoun	3sg.emph
ir	Verb	perceive
Aisi	ProperNoun	Aisi
ɨbɨr	Verb	1pl.ctrf
awoŋ	Noun	tree.sp
sɨban	Noun	flatland
nawam	Noun	turtle
ŋ	Determiner	?
maŋsaŋ	Noun	bird.sp
yak	Verb	come.up
bakr	Verb	spoil
sɨm		brother
ikɨ	Noun	sore
nɨ		3.poss
kak	Verb	tie
oŋ	Determiner	top
sets		search
inap		able
yabarke	Noun	fish.sp
mɨtɨ		leave?
mɨrtar	Noun	tree.sp
tamar	Verb	turn.into
debi	Verb	meet
yoret		alright
nokag	Noun	daughters
inoisi		much
agr	Verb	distribute
bodi	Noun	body
sar	Verb	dance
apiŋ	Adjective	roasted
akam	Adjective	huge
sɨrɨm	Noun	anger
kuriŋ	Noun	fasting
abi nokag		young.girl
na	Particle	and
anɨmɨnɨ	Adjective	small
katam	Noun	head
kɨtɨŋ	Particle	and
mugunda		all
ndɨ	Determiner	exst
momb	Verb	pile.up
iw	Verb	hit
upo kɨsɨr	Noun	rice
kri	Postposition	inside
Tubsakaŋ	ProperNoun	Tubsakaŋ
boi		grandmother
ur	Verb	call.out
kopar	Noun	rat
buŋim		gather
nɨrɨgunuŋ	Pronoun	3pl.obj
Gare	ProperNoun	Begasin
okei	Interjection	okay
teŋkim		thank
waya	Noun	wire
sɨmbɨndɨm	Noun	tree.sp
Sali	ProperNoun	Charlie
kumor	Noun	bird.sp
beruŋ	Verb	3pl.fut
sarata	Noun	comb
sapos	Particle	if
pa	Adverb	only
upo	Noun	sand
i	Noun	urine
bris	Noun	bridge
kwareb kekreŋ	Noun	bird.sp
sendam	Noun	lastborn
tɨb	Verb	fight
sɨme	Noun	rope
simbri		green
awoŋ gir	Noun	bug.sp
kɨbar	Verb	carry
kepa	Adverb	just
kɨmɨr	Noun	eel.sp
kɨtɨ	Noun	tree.sp
migirum	Noun	forehead
spoksmen	Noun	spokesman
kros	Noun	conflict
rekodiŋ		recording
sembr	Verb	shoot
kuŋ	Verb	1pl.ds
im	Verb	put.in
aŋ	Verb	1pl.ipst,1pl
dibelopmen	Noun	development
moneŋ	Noun	tree.sp
nuŋ	Pronoun	3sg.obj
sanɨ kakim	Noun	bug.sp
narɨb	Pronoun	2pl.emph
mar	Verb	make,call.to
Iran	ProperNoun	Iran
tok	Verb	chase
umu	Noun	right.arm
samtiŋ	Noun	thing
si	Noun	seed
Kwanam	ProperNoun	Kwanam
somɨ mesɨŋ	Noun	snake.sp
ŋgi		mother
am	Noun	bamboo
Ramu	ProperNoun	Ramu
watab	Noun	growth
duŋge	Noun	bird.sp
jabar	Noun	bug.sp
impoten	Adjective	important
gatɨ	Noun	raft
yarɨm bosi		wallaby.sp
Awar	ProperNoun	Awar
naka	Pronoun	2sg.poss
bildiŋ	Noun	building
dager	Noun	cane
ɨbasɨrɨ	Verb	2pl.ctrf
it	Verb	get?
kɨs	Verb	peel
koprat	Verb	jump.over
mok		sister
mɨs	Noun	sap
aŋgɨ	Noun	leg
uruŋ	Noun	wellness?
oŋ	Verb	3pl.ipst,3pl
garaŋ	Adjective	long
moye	Noun	tree.sp
wek	Verb	come.2sg.imp
dakware	Noun	bird.sp
dugag	Noun	ear
abab	Noun	old.woman
sarɨndi	Noun	tapeworm
baŋ	Verb	1pl.ctrf
taŋa	Verb	ss.delay
kɨkre	Adverb	well
sisir	Noun	tree.sp
nu	Pronoun	3sg
barke	Noun	tree.sp
gɨsɨŋ	Postposition	from
makar	Noun	lizard.sp,tree.sp
gi	Particle	foc
sopay	Verb	finish
poket	Noun	pocket
gi		father
e	Verb	3sg.ipst,3sg
mor	Adjective	white
togapam	Verb	stand
gwarigwari	Noun	tree.sp
gyou	Noun	snake.sp
togay	Verb	climb
ogi	Verb	2pl.ds
meŋɨ	Noun	baldness
dril	Noun	drill
taŋar	Noun	leaf
uri	Verb	scratch
kesɨmɨnɨ		slowly
bos	Noun	boss
kon	Noun	corn
Remsi	ProperNoun	Ramsey
itok	Verb	take.in,take.up
kwi		son
gyou kuru	Noun	snake.sp
kwanam	Noun	tree.sp
ubiaŋ	Noun	thunder
kiraŋ	Noun	platform
tukuŋ	Noun	hole
ur	Noun	ground
kibra	Noun	manioc
ga	Determiner	md
yakarate		full
aye	Noun	sago
mɨŋiŋgat	Verb	bring.in
makar		5.days.after.today
taŋgeb	Noun	area.under
mɨrɨ	Noun	mushroom
wai	Noun	bamboo.sp
sagɨ tɨbe	Verb	fight
mamaŋ	Adverb	in.plain.sight
gɨbam kurikuri	Noun	ant.sp
kapa	Noun	roofing
redi		ready
sit	Noun	sheet
mukoŋ	Noun	bird.sp
kɨŋɨ	Noun	k.o.arrow
kenaŋ	Noun	fish.sp
kuŋar	Adjective	big
imu	Noun	louse
kamewar	Noun	spider
aŋirusa	Noun	bird.sp
Gedso	ProperNoun	Gedso
mɨŋɨr	Noun	penis
bɨbɨr	Noun	soup
mak	Noun	size
nagursaŋ	Noun	bee
ar	Verb	do
igu	Verb	give
kur		be.imp?
amug	Postposition	under
imbɨr	Adjective	bad
kapor		male
yopa		enough
wokim		make
bugur	Noun	tree.sp
asir	Verb	be.big
Moses	ProperNoun	Moses
melen	Noun	melon
eŋ	Verb	1sg.ipst,1sg
kogor	Noun	four
kubro	Noun	plate,canoe
katig	Postposition,Noun	li,top
iŋ	Postposition	loc
amamas		happy
e	Interjection	hey
kobeyitɨ	Verb	cook.ss
beraŋ	Verb	1pl.fut
bekim		answer
kuŋarpa		many
koben	Verb	cook.and.eat
kibɨ	Noun	in.law
yabɨr kapɨkapɨ	Noun	bird.sp
mai	Verb	2pl.imp
ara	Determiner	fd
Imelda	ProperNoun	Imelda
numor		top
aram	Verb	do
krɨsoŋar	Verb	wash
herikopta	Noun	helicopter
kain	Adverb	kind
amɨ	Noun	breast
tɨbsɨkram	Verb	join.together
sekrenda	Quantifier	three
lustiŋtiŋ		forget
sarɨ	Noun	gums
Romsi	ProperNoun	Romsi
akɨ	Particle	maybe
berar	Verb	2pl.fut
yokoŋ		uncle.1.poss
kekwar	Verb	wash
mitopreŋke	Noun	eel.sp
goŋarem	Noun	tree.sp
ba		ptcp
kiruŋ	Verb	3pl.imp
nyaŋ	Adjective	ripe
mɨŋ	Verb	make
kɨmbɨ	Adverb	able
nau	Particle	now
urig	Noun	ground.loc
dɨbɨ	Noun	skin
bes	Verb	des
anɨ	Pronoun	1pl
kikɨ		new
egɨnɨŋ	Verb	3sg.ds
aŋ koramba	Noun	bird.sp
iŋgat	Verb	go.in
gandum	Noun	lizard.sp
bombar	Noun	grass
Sisi	ProperNoun	Ceecee
igo	Noun	loincloth
uk	Verb	cut,come.off
pɨrar	Noun	snake.sp
garbi	Verb	make
irɨdɨgr	Verb	fall.off
mɨgat	Verb	finish
kagɨ	Adverb	again
orait	Interjection	alright
ai	Noun	what
mimiŋ	Noun	tree.sp
apɨr	Noun	dog
namiraŋ	Noun	k.o.taro
Ukoi	ProperNoun	Ukoi
suŋgoŋ	Noun	lower.back
nimɨtɨ	Noun	hunger
kibiŋ	Noun	saliva
hap	Noun	place
nagum	Noun	neck
brɨr		flapping
kamor	Noun	mustard
ki	Noun	speech
na		2.poss
grasnaip	Noun	grass.knife
kɨnɨgam	Verb	sit
narɨkuŋ	Pronoun	2pl.poss
sekreŋ		three
nɨba	Determiner	qd
mipla	Pronoun	we
inomaŋgi		huge
amu		down
briŋim		bring
mom		husband
benɨm	Noun	lizard.sp,bug.sp
dɨb sɨkɨb	Noun	bird.sp
teneb	Noun	Milky.Way
nɨtɨ	Verb	eat.ss
ndɨ		daughter.il
kuŋ	Determiner	acc
am	Noun	rain
Marem	ProperNoun	Marem
mome	Noun	bee.sp
su	Noun	butt,feces
aŋar	Noun	sunshine
gan	Noun	gun
narɨ	Pronoun	2pl
saŋgwe	Noun	tree.sp
sɨki		grandfather
kakre	Verb	tie
mɨg	Verb	come.down
sabɨsaŋ	Noun	turtle.sp
Kume	ProperNoun	Kume
wanɨm	Noun	bamboo.sp
mary	Verb	become
ke	Noun	song
giro	Noun	flame
rekod		record
niŋ	Noun	taro
kɨnɨŋ	Determiner	pl
painim		look.for
sagre	Noun	tree.sp
koŋ	Particle	quot
akɨr	Noun	middle
kondam	Noun	tree.sp
mandɨ	Adverb	compl
mug	Verb	go.down
kiap	Noun	kiap
dɨbɨr	Noun	cucumber
gɨ	Determiner	exst
mugram	Verb	fit
bai	Particle	fut
siŋ	Noun	navel
byaŋ	Verb	1sg.fut
kum		female
kemaŋam	Noun	firstborn
ripot	Noun	report
bɨŋ	Verb	1sg.ctrf
ite	Verb	bring.imp?
asig		strong
tɨŋar		brother.il
bikos	Particle	because
digiŋ		dirty
Bekenik	ProperNoun	Bekenik
yok	Verb	go.up
Sepu	ProperNoun	Sepu
opa	Noun	offering
mɨror		slippery
is	Verb	pee
waŋ kabakaba	Noun	possum
Akwaŋgi	ProperNoun	Akwangi
amɨke	Noun	tree.sp
kantri	Noun	country
abur	Noun	bamboo.sp
nɨrukuŋ	Pronoun	3pl.poss
o	Interjection	oh
kwarag	Noun	ginger
Esayel	ProperNoun	SIL
ugam	Noun	throat
irar	Noun	edge
pemli	Noun	family
kok	Verb	flee
ikak	Verb	follow
gaŋ		?
kabe	Noun	taro.sp
beŋ		
stori	Noun	story
bur	Noun	tobacco
Sɨrakura	ProperNoun	Sɨrakura
mɨndam	Verb	think
nɨnɨ		
ye		I
tapr	Verb	serve
kekreŋ	Noun	vine
em	Pronoun,Particle	cop,3sg
sikre	Verb	catch.fish
soŋgrɨm	Noun	fish.sp
aŋ	Noun	water
kunim kɨsɨr	Noun	ant.sp
Tamsen	ProperNoun	Tamsen
yagr	Verb	stab
apɨsɨ		white
garas		goggles
pinisim		finish
teŋkyu	Particle	thank.you
Esdisi	ProperNoun	SDC
sori	Verb	bathe
kiŋgyauŋ	Noun	bird.sp
dagar	Noun	bone
uram		aunt.1.poss
Kawag	ProperNoun	Kawag
n	Verb	eat
kɨbegiŋ		half.full
sebis	Noun	services
mɨt	Verb	leave
mug		swelling.up
moses	Noun	thing
wakr	Verb	look.for
mɨnɨ	Noun	back.of.head
r	Verb	be?
pirim	Noun	rind
kobir	Noun	bug.sp
kon	Verb	plant
gragra	Quantifier	distr
kurum		dry
kimɨ	Noun	bug
kirapim		raise
sɨkrat	Verb	come.out
kominiti	Noun	community
a	Interjection	ah
use	Noun	tree.sp
nɨku	Pronoun	3sg.poss
narɨgunuŋ	Pronoun	2pl.obj
warɨrabi	Noun	tree.sp
mat	Verb	paddle
itu	Noun	tobacco
kwareg	Noun	ginger
gi		?
akuram	Verb	show
akagɨr		long.ago
tug	Noun	hole
sɨkaŋsɨkaŋ	Adverb	totally
ogɨnɨŋ	Verb	3pl.ds
geba	Noun	tree.sp
riŋ		phone
potu		straight
makɨ	Noun	tooth
mɨnamɨna	Adverb	very.quickly
Yom	ProperNoun	highlands
mam	Verb	look.for
amor	Adverb	tomorrow
luluai	Noun	representative
ibɨr	Noun	ashes
suk	Verb	defecate
akar	Noun	beard
yama		mother.1.poss
arɨreŋ arɨreŋ	Noun	bug.sp
nor	Noun	daughter
yaŋ	Pronoun	1sg.obj
krokam	Noun	snake.sp
kiŋ	Verb	1sg.ds
unumbɨ	Noun	bug.sp
bepa	Noun	bug.sp
ga	Particle	top
tɨmab	Noun	rib
kemaŋ	Noun	firstborn
yandɨ	Noun	tree.sp
isi	Verb	carry
boru	Noun	tree.sp
sakar	Noun	left.arm
nimanima	Noun	bird.sp
na	Determiner	here?
Nanum	ProperNoun	Nanum
Mande	ProperNoun	Monday
sɨkɨbyaŋ	Noun	food
Kiram	ProperNoun	Kiram
andasten	Noun	understanding
yaŋpela		young
maram	Verb	hang
am	Verb	fly
kraŋ	Noun	tree.sp
pabɨ		all
sukre	Verb	peel
ukukum	Verb	extinguish
bogor		handle
gwandam	Noun	old.man
mutuŋ	Noun	tree.sp
mait	Verb	2pl.imp
Enet	ProperNoun	Annette
mokɨm	Noun	greed
Yues	ProperNoun	U.S.
kyam	Noun	salt
kapɨ gogob		butterfly
asiki		grandfather.1.poss
gomar	Noun	lizard.sp
Fraide	ProperNoun	Friday
urkame	Adverb	dawn
umiŋ	Adverb	yesterday
tiki	Verb	fill.up
bugom	Noun	lizard.sp
er	Verb	hab
kogab	Noun	snake.sp
rausim		remove
konou	Noun	tree.sp
Igoi	ProperNoun	Igoi
sɨbe	Noun	grasshopper
kabar	Noun	shoulder
baŋ	Verb	2sg.ctrf
senisim		change
ab	Noun	fire
uror	Noun	shouting
tɨkɨr	Noun	tree.sp
sakar	Noun	k.o.stone
naŋam	Noun	frog
prat	Verb	cross
mun	Noun	month
salim		send
yaka	Pronoun	1sg.poss
geŋgor	Noun	tree.sp
hausik	Noun	hospital
niŋ		white
bairo	Noun	pen
nɨŋ		sharp
kayaŋgi	Noun	bird.sp
