gumga	Noun	tree.type
gŋgreŋw	Verb	hang.up
tabu	Noun	gun
tari	Adjective	only?,enough
akleŋ	Verb	look.down
ŋi	Noun	bird
haru	Noun	handle
qala	Noun	sister.i.l
ko	Noun	ashes
boimben	Noun	tree.type
tmo ŋondom	Noun	banana.type
amal	Noun	snake
Soŋgum	ProperNoun	Songum
Susen	ProperNoun	Susan
Lolobau	ProperNoun	Lolobau
kakar	Verb	shake
kine	Noun	hole
koŋw	Verb	throw
gumbeŋ	Verb	whip
baket	Noun	bucket
gseŋ	Noun	tree.type
andabim	Verb	mount
lil	Adverb	two,twice
syi	Verb	give.to.1sg
kde kendi	Noun	fig.type
mandu uro	Noun	tree.type
yaŋgim	Noun	rain
rais	Noun	rice
hognu	Noun	tree.type
bjagam qawa	Noun	tulip.type
stori	Noun,Verb	tell.story,story
mul udu	Noun	tree.type
mnjqom	Noun	skin
lain	Noun	group
emb	Verb	sg.fpst.ss
gunje	Noun	tree.type
añul	Noun,Verb	be.sick,poison,sickness
jŋgai		only?
yasu ŋondom	Noun	grass.type
kantri	Noun	country
tf	Interjection	speech.error
tnnem	Verb	be.still
budu	Noun	dirtiness
gori	Noun	paint.tree
jimjim	Noun	tree.type
ndqori	Noun	stump
asbu	Verb	spy
ynum	Noun	tree.type
fes	Adjective	first
hulau	Verb	put.pl.obj
ta	Verb	wander
qaji	Verb	piece
sbim	Noun	inside?
monjoŋ	Noun	bee.sp
qien	Verb	celebrate
walwel	Verb	wander
helijge	Noun	tree.type
Bwai	ProperNoun	Bwai
huglub	Noun,Verb	stomach,be.pregnant
kumbri	Noun	wild.banana
salu	Noun	vine.type
kubamo		
stret	Adverb	exactly
kuboŋ	Noun	canoe
gri	Noun	wings
hap	Noun	piece
sŋgi	Verb	laugh
yau	Noun	wallaby.sp
mel	Verb	cry
qmbumbeŋ	Noun	jews.harp
wo	Postposition	com
jaŋi	Noun	pot.type
kiŋgleŋ	Noun	tree.type
las	Adjective	last
kmoŋ		sleep?
sqol	Pronoun	1du
yaru yom	Noun	tree.type
damum	Noun	meat
gomor	Noun	basket
kiakiaw	Noun	banana.type
gobrom	Noun	plant.type
o	Interjection	oh
kleŋw	Verb	cross?
tokples	Noun	language
qas	Particle	?
pndandaŋ	Noun	beautyberry
wanam	Noun	palm.type
kaŋgel	Noun	butterfly
kumbi	Noun	grass.type
paŋ	Noun	tree.type
kobo	Verb	be.good
yo	Interjection	no
hembreŋ		
malolo	Verb	rest
ŋgoru	Noun	plate
yebenji	Noun	land
sle	Verb,Adverb	before,do.earlier
sndaqum		
autim	Verb	publicize
haŋar?	Noun	galip.nut
diŋgin kumblu	Noun	vine.type
qamam	Noun	palm.type
lwu	Adverb	two.days.ago
i	Pronoun	poss?
ŋareŋ	Verb	hot,be.hot
lukautim	Verb	care.for
ya	Noun	water
kenw	Verb	not.able
noqol	Pronoun	3du
kwa	Verb	break
ubu	Noun	shell
qasur	Noun	trap
qori	Noun,Verb	house,build.house,village
hatim	Verb	scold
kumbu	Verb	hold
gndegnde	Noun	wild.banana
qsim		
mblaŋ	Noun	fish.sp
gum waŋgombi	Noun	taro.type
qri kumjeŋ	Noun	tree.type
wansoru	Noun	sugar.type
hahaha	Interjection	haha
tne	Verb	approach?
qel	Verb	decorate,dress
dal	Noun,Verb	package,wrap
dndoŋ	Verb	cut.off
mag	Verb	limit
i	Verb	1sg,1sg.ss
jqo	Verb	come
dou	Verb	share
boimben jqalub	Noun	tree.type
gŋ	Verb	?
i	Pronoun	1sg
idauŋ	Verb	carry.on.pole
umor		?
tumbuna	Noun	ancestor
pegi jqalub	Noun	tree.type
s	Particle	agt,ins,abl
aŋgi	Noun	bump
ñam	Noun	mother
qasir		
damu	Adverb	very
kuwi	Noun	nettle
Qsmolsnaq	ProperNoun	Qsmolsnaq
gagai	Adverb	always
Kaiŋgaso	ProperNoun	Kaingaso
titimin mul	Noun	vine.type
Mbolon	ProperNoun	Mbolon
saryem		
snja		?
e	Particle	q,imp
tenemb	Adverb	directly
bubu	Noun	bamboo.type
yakar kbul	Noun	tree.type
waglu	Noun	epiphyte
knab		hungry
medi	Noun	greens
kumom	Verb	sun.set?
tai	Verb	push
sagul	Noun	tree.type
gum lanis	Noun	taro.type
ji	Noun	nose
todu kde	Noun	cucumber
dagi	Verb	carry on shoulder
glaŋ	Noun	tree.type
gdai		one
tum	Noun	plant.type
nimbi	Pronoun	3pl.poss
wil	Noun	breast
kndqa	Verb	pinch?
salqan	Noun	kite.type
jgel	Verb	dance
suli mnjraŋ	Noun	plant.type
kbul	Noun	widow
Marwai	ProperNoun	Marwai
tmbum	Noun	tree.type
Kumqoru	ProperNoun	Kumqoru
skul	Noun,Verb	school,attend.school
dmgeŋ	Noun	vine.type
keri	Verb	able?,be.enough
kondi	Noun	palm.type
ŋg	Verb	3pl,3pl.ss
Preŋk	ProperNoun	Frank
brndaŋ	Verb	break?
Yag	ProperNoun	Yag
uro	Noun	crayfish.sp
habqab	Adjective	outside,below,low?
pe	Verb	remove,wipe
Kimbe	ProperNoun	Kimbe
moñeŋ	Noun,Verb	woman,become.woman
aŋgbon	Noun	tree.type
kaigou	Verb	go.around
sŋgleŋ	Noun	tree.type
nambi	Noun	she.oak
Muŋgukulu	ProperNoun	Munggukulu
u	Verb	3sg
sem	Adverb	quietly?
aji mul	Noun	vine.type
mmaden	Noun	grass.type
domboraŋgi	Noun	umbrella.tree
tutausen	Noun	two.thousand
klad	Verb	watch.over
qamaŋ kraŋ	Noun	tree.type
kuru	Noun	sprout
g	Verb	inf,?
sibim	Noun	guts
ŋa	Noun	yam.type
wasu	Verb	tell
lemi		what
mano	Adverb	above?
jqraŋ	Noun	wild.pandanus
bran		
ñqro	Verb	smash
ibel	Verb,Adverb	tomorrow,become.tomorrow
dur		
gum snji	Noun	plant.type
mambrum	Noun	plant.type
somborñam	Noun	tree.type
kominiti	Noun	community
plaŋgu	Noun	plant.type
kebem	Noun	wild.sugar
mbo	Adverb	maybe
blau	Verb,Adverb	afternoon,become.afternoon
ye	Interjection	yeah
ni	Verb	2s.obj
kere		
huñaŋ	Verb	rest
roŋ	Adjective	wrong
gum risa	Noun	taro.type
lainab	Verb	line.up
alim ise	Noun	yam.type
malu	Noun	yard
bukomboŋ	Noun	tree.type
tqol	Pronoun	2du
user	Verb	show
lolol	Verb	forget
geru	Verb	make,fix,do.well
rai	Noun	banana.type
damŋai		?
har	Verb	open
teb	Verb	plant
mñaŋ yasu	Noun	rattan.type
jŋgari	Noun	sap
kabum snja	Noun	cordyline.type
tundu huyim		
ob	Verb	3sg.fut.ss
pogo	Verb	lean
pga	Verb	bend.over
giŋgeŋ	Adjective	dark
jgalub		
jeqel	Noun	vine.type
hayaŋ gujmo	Noun	fern.type
gŋgeŋ	Noun	fishtail.palm
moloŋ	Verb	drill,break.out
krdu	Noun	tree.type
rgir	Verb	wobble
Kubri	ProperNoun	Kubri
jgar	Noun	ghost
huŋgro	Noun,Verb	fuss,behavior
kodigru	Noun	tree.type
gum kabum	Noun	cordyline.type
yedi	Noun	tree.type
gaundo	Noun	wild.yam
aŋgal	Verb	first,go.first
manjmin	Noun	tree.type
paba	Noun	papaya
hula	Verb	turn.palm.up
umor kodigru	Noun	tree.type
minmin	Noun	earthquake
ŋgrqos	Noun	tree.type
e	Interjection	hey
kaye	Verb,Interjection	thank.you,thank
gagu	Noun	stickbug
sŋgra	Verb	lift
wali	Noun	sibling.i.l
qian gebiw	Noun	strangler.fig
Kareŋ	ProperNoun	Kareng
Mnjeŋ	ProperNoun	Minjim
maiŋgom huyamai	Noun	plant.type
Matela	ProperNoun	Matela
dqaŋ	Adjective,Verb	line.up,parallel
ba	Verb	bark,yell.at?
karaŋ	Noun	vine.type?
soŋ	Noun	wallaby.sp
wad	Verb	tie
mbsaŋ qabeŋ	Noun	croton
sqou	Verb	cup.hands
jjŋgur	Noun	nose
qabeŋ	Noun,Verb	hand,shake.hands
yuwel	Noun	sea
mŋgul sumyag	Noun	banana.type
Walim	ProperNoun	Walim
hunji	Noun	bishopwood
sumñam	Noun	crayfish.sp
daŋo	Verb	argue?
be	Verb	up,go.up
wasu knjalim	Noun	ant.type
krndum	Noun	cardamom
snjleŋ kumblu	Noun	tree.type
jnjam	Verb	sit.one.by.one
lalu yom	Noun	tree.type
woŋ	Particle	neg.fut2
qndeŋgoŋ	Adjective	small
Konoŋ	ProperNoun	Konong
jjgel	Noun	tree.type
ujem	Noun	bandicoot
Enru	ProperNoun	Andrew
toqor	Noun	family
ŋo	Verb	scold?,be.angry
gum ujama	Noun	taro.type
asu jorŋgor	Noun	tree.type
gambu	Noun	fly
dg	Verb	2pl,2pl.ss
jojo	Noun	wild.pepper
som	Noun	snake.type,banana.type
mul	Noun	vine,string
bo	Adverb	where
hor	Verb	dig
hatwok	Verb	toil
marem yua	Noun	wild.mango
baŋgu	Noun	k.o.arrow
kumblu	Adjective	blue
kraŋgim	Noun	banana.type
mogom	Noun	edge,area.near
neneŋ	Noun,Verb	thought,think
wo	Noun	great.grandfather,grandfather
sqa	Noun	salt
Asgubu	ProperNoun	Asgubu
bamen	Noun	cloud
ŋur	Noun	mountain
qndar	Adjective	small
qdqom	Verb	swallow
boi	Noun	boy
prdoŋ	Verb	break?,come.loose
ŋgraqaŋ	Noun	tree.type
qol		
sogrob	Noun	pupa
blebleŋ	Noun	bridge
snjleŋ huyim ñŋglaŋ	Noun	tree.type
paŋ	Verb	open
mblmel	Noun	wild.taro
toŋ	Verb	pick,come.loose
kumim	Adjective	dry
am	Interjection	um
Sraqaqu	ProperNoun	Sraqaqu
awe	Adjective	terrible?
ulim	Noun	hair
grager	Noun	fig.type
mandu	Noun	tree.fern
ugam	Adverb	morning
jmbaŋ	Noun	grass?
ul	Verb	see,weave
qaqais		after
qondeŋ	Verb	stand
qian	Noun	strangler.fig
qadaŋ	Verb	bite
asu ŋondom	Noun	plant.type
suweŋ	Noun	navel
qanju	Adjective,Verb	burn,cooked
Bulum	ProperNoun	Bulum
sambi glaŋ	Noun	yam.type
kegerw	Verb	gather
touŋ	Verb	erect
saman	Noun	ylang.ylang.tree
qalub	Verb	three,be.three
hobob mul		
bdibda	Verb	jump.around
sŋgar	Noun	rind?
kareŋ	Noun	wild.banana
kodegru		
Gañul	ProperNoun	Gañul
tombroŋ	Noun	nettle.tree
mam	Noun	dog,police
hobob ti	Verb	fence.in
saŋgumo	Noun	sorcerer
qnjqa	Verb	be.wet
qa	Noun	betelnut
jagbu		?
kumjeŋ	Noun	tree.type
du		spec
subom	Noun	mouth
hen	Verb	insert,wear
imem	Noun	frog
wo	Noun	war
knjarum	Noun	cliff
komboŋ yu	Noun	sugar.type
tu	Interjection	two
snjweŋ yom	Noun	tree.type
breŋ	Verb	roll?
eno		exph?
re	Verb	pull,breathe.in
tigdaŋw	Verb	block
wabu	Noun	grasshopper
bli	Adverb	again,also
mŋgul buagu	Noun	banana.type
tali	Noun	possum.type
todu waru	Noun	cucumber
jmbal	Verb	put.over?
sambi be	Noun	yam.type
waru		?
gym	Noun	uncle.3.poss
a	Noun	eye
qaqo	Noun	lime
luaŋ		?
Guluŋ	ProperNoun	Gulung
kumoŋ	Noun	sun
gabi	Noun	tree.type
glaŋ mbaŋ	Noun	tree.type
de	Noun	day
yubru	Noun	shade
Kargu	ProperNoun	Kargu
kumu	Adjective	black?
baiskol	Noun	bicycle
momaden	Noun	vine.type
mbqam	Verb	full,be.full
simbi	Pronoun	1pl.poss
yqou	Verb	leave
kombgoŋ	Noun	water.rat?
ŋel	Verb	vomit
bara	Noun,Verb	speech,talk
isi	Verb	hear
qolu	Noun	broth
alim wajlu	Noun	yam.type
baji	Noun	trap
wanem	Interjection	what
waho	Interjection	yes
ambu	Noun	source?,banana.type
suŋgur	Verb	push
dokta	Noun,Verb	doctor,be.doctor
blablu	Adverb	again?
ser	Adjective,Verb,Adverb	fast,hurry,quickly
kugwa	Noun	crab
ajimar	Noun	heart
daŋgal	Noun	stick,ten.kina
Komboŋ	ProperNoun	Kombong
marem kradi	Noun	plant.type
wo	Verb	call
ŋalub	Noun,Verb	head,nod?
turw	Verb	happen.with
yasu gruo	Noun	rattan.type
gayeŋ	Verb	hang
tija	Noun,Verb	teacher,be.teacher
usi	Adverb	now,today
Galib	ProperNoun	Galib
smbrum	Noun	tree.type
goroŋ	Verb	slide.in
qudu	Verb	shake.in.fear?
bu yqaŋ humbaŋ	Noun	tree.type
sreŋw	Verb	cover?
kiakial	Noun	tree.type
saŋgai	Adjective,Verb	long,be.long
ŋel	Verb	du.fpst?
uli	Noun	thing,food
yom	Noun	tree
tumbe	Noun	plant.type
q		iter
namar yqaŋ	Noun	vine.type
hoda		
gimbu	Adjective	how.many,when
slel		
wal	Noun	pumpkin
koli	Noun	thunder
rumañiŋ kumblu	Noun	vine.type
qamam yu	Noun	sugar.type
qar	Noun	tree.type
ŋendi	Verb	disobey?
titer	Adverb	stumbling
pmbauŋ	Verb	shell?
arait	Interjection	alright
Wqaŋ	ProperNoun	Wqang
muñipra	Noun	sweat
pidim	Verb	feed
saqo	Adjective	raw
kopi	Noun	coffee
henem	Noun	inside?
g	Verb	2sg.imp
palu		?
buma	Noun	vine.type
ñañi	Noun	grassland
yedel	Verb	bend.down
glimbu	Noun	tree.type
yqan		?
gori qawa	Noun	paint.tree.type
hobob	Noun	fence
towol	Noun	tree.type
yapreŋ	Noun	dragonfly
njurom	Noun	creek
saro		
yu wagu	Noun	sugar.type
koŋgloŋ	Noun	snail.shell
selem	Noun	wild.sugar.type
hilum	Adjective,Noun	male,banana.type
hlul	Noun	fern
Mai	ProperNoun	Mai,Mai
kaŋgi	Noun	tree.type
ŋgrim	Verb	growl
sndaqom	Noun	vine.type
tgn	Verb	poison?
ñqraŋ	Adjective	chatty
tondoŋ	Adjective	real
pna	Verb	beat,shoot
Aswi	ProperNoun	Aswi
handqar gebiw	Noun	vine.type
w	Adjective	?
kulqom	Noun	moon
kebem mbrum	Noun	tree.type
ti	Verb	take
ni	Verb	2sg.obj
kukulboŋ	Noun	shell
huyamai	Noun	wife
as	Verb	desid
maket	Noun	market
kanjom	Noun	bean.type
debi	Verb	carry.on.head
yasu	Noun	rattan
walmun kajqreb	Noun	bamboo.type
tamoŋw	Verb	gather
ñamoŋ	Verb	whisper?
banu bo	Noun	soft.ironwood
huli	Noun	vagina
gebi mul	Noun	vine.type
glo	Adverb	maybe
hoŋ	Verb	peel?
diŋgin	Noun	vine.type
hamblum	Noun	vine.type
albim	Verb	help
tenteŋ	Adjective	true
boger	Noun	palm.type
jiŋgeni	Noun	possum.sp
Miryam	ProperNoun	Miriam
haleb	Noun	face
slum	Noun,Verb	sing,song
mnŋgi		
hembri	Verb	scoot?
usu	Verb	splash
yodu smbañum	Noun	fig.type
banu	Noun	ironwood
maŋgraŋ	Noun	vine.type
aya	Verb	not.want
alim gseŋ	Noun	yam.type
hai	Verb	chop
naski	Noun	banana.type
nemi	Verb	what?,do.what
jamu	Noun	vine.type
kañaru	Noun	hibiscus
aŋgum	Noun	butt
bŋgum	Noun	tree.type
siod	Noun	shirt
makim	Verb	mark
umbu gagiw	Noun	fig.type
nambaut	Verb	flail?
d	Verb	2pl,2pl.ss
kibim	Verb	give
ulemi	Noun	everything
mam lam	Noun	police
bdda	Verb	do.suddenly
hab	Noun	place,part
sna	Verb	boil
amoŋ	Noun	father,k.o.sibling
Mubun	ProperNoun	Mubun
sgi	Verb	1pl.obj
mbsel	Noun	banana.type
qje	Adjective,Verb	closed,close
maqrum	Noun	opening
qri	Adjective	straight
weneŋ	Noun	grass.type
weñeŋ	Noun	bee.sp
wadu	Noun	vine.type
bgen	Noun	edge?
raboŋ	Verb	cover
gel	Verb	peel
pegi	Noun	bandicoot.berry,paper
ñi	Verb	eat
pog	Verb	open?
inaudible	Interjection	inaudible
maremb sri	Noun	tree.type
q	Noun	pl
tedni	Noun	vine.type
mneŋ	Verb	stay.sg.prs
ya kradi	Noun	plant.type
qneneŋ		
damŋai kodigru	Noun	tree.type
saŋal	Noun	crab.sp
qaqu	Noun	post
hel	Verb	clear.forest
ŋgsqoŋ gebiw	Noun	fig.type
drosi	Noun	wild.cucumber
yeŋgreŋ	Noun	tree.type
welñam	Noun	lap
kub	Noun	top
ujemjali	Noun	tree.type
hulo	Noun	lizard
mŋgul qam	Noun	plant.type
[...]i		intens?
dauru	Verb	follow
klqom	Adjective	dirty
uŋgoŋ	Noun	tree.type
smo snji	Noun	tree.type
kiŋgi kaju	Noun	fig.type
Bliŋai	ProperNoun	Blingai
delmeŋ	Noun	grass.type
jagi	Adjective,Particle	foc?,different
qoqo	Verb	look
kaju	Adjective	rough
karam	Verb	cry.out
yodu krum seŋ	Verb	vengeance
laip	Noun	life
wqaŋg	Verb	shine?
bo	Adjective	softwood
tundil	Noun	tree.type
kundoŋ	Noun	millipede
Abul	ProperNoun	Abul
ŋe	Verb	?
ima	Noun	tree.type
taim	Noun	time
dau qar	Noun	fig.type
mari	Verb	harvest?
maqraŋ	Noun	tree.type
jo	Noun	betel.pepper
bal	Noun	ball
qwa		thirsty?
gumqa		
mareŋ	Noun	forest
sŋil jqalub	Noun	pandanus.type
ndeŋw	Verb	pull?
knjo	Noun	meat
ñqre ŋgururu	Noun	fig.type
huyou	Noun,Verb	cook,cookout
qo	Verb	see
wanum	Noun	beard
kogu	Noun	vine.type
bu hulgub	Noun	tree.type
gŋgreŋ	Verb	hang
ged	Verb	sg.fpst
yar	Noun	year
qsmol	Noun	fig.type
waqutombol	Noun	knee
bleŋ	Noun	log,platform
krab	Noun	fig.type
heni	Adverb	high
d	Verb	sg.rpst
qaqa	Noun	armpit
pbow	Verb	slice
asaŋ	Noun	in.law
sandu	Verb	stay.close?
mŋginjar	Noun	tree.type
qambqo	Noun	tree.type
riŋgi	Noun	tree.type
mblam	Noun	shoulder
kkanjom	Noun	vine.type
daleŋ	Noun	flying.fox
rŋaŋ	Noun	tree.type
qanan	Noun	left
blupla	Adjective	blue
wi	Verb	make?
olsem	Interjection	so
huli bqali gunje	Noun	tree.type
seg smbaŋ	Noun	taro.type
Korom	ProperNoun	Korom
mul bŋgum	Noun	tree.type
kulu	Verb,Adverb	night,be.night
Baŋ	ProperNoun	Bang
ñam	Noun	plain.sight
kulon	Noun	bush.type
yom qqradeŋ	Noun	tree.type
mumoŋ	Noun	bee.type,guest.tree
sg	Verb	give.to.1pl
qreb	Adjective	exist?,whole
mbaŋ	Adjective	very.fast
lile	Noun	grass.type
ŋger	Noun	bamboo.type
tadeu	Verb	meet
au	Verb	come.2sg.imp?,come.imp
ib	Verb	1sg.fut.ss
waliw	Verb	afflict?
tuar	Noun	banana.type
Qandqai	ProperNoun	Qandqai
ywel mul	Noun	vine.type
graŋ	Adjective	spindly
wol	Verb	hit.3sg.obj,cross
qawa	Noun	plant.type
mul qqradeŋ	Noun	vine.type
bjagam yom	Noun	tree.type
kal	Verb	build
Qalqai	ProperNoun	Qalqai
wou	Noun	tree.type
baye	Noun	vine.type
ugel	Adjective	ugly
gum danama	Noun	taro.type
tur	Verb,Adverb	join,milk?,together
Tiyaisi	ProperNoun	TIC
blaib	Adverb	again
tuba	Adjective,Verb	short,lack
arsasi	Noun	vine.type
riŋgi yom	Noun	tree.type
pelet	Noun	plate
ñoqor	Verb	crush
maqr sambi	Noun	wild.yam.type
poŋ	Verb	appear?
ŋadu snji	Noun	tree.type
tgi	Verb	2pl
musil	Noun	plant.type
mŋgini	Verb,Adverb	later,be.later
jar	Noun	platform
sou	Noun	brother.i.l
gilam	Noun	brain
juaru	Noun	tree.type
hulogmam jqalub	Noun	tree.type
Poma	ProperNoun	Former
snjoŋ	Verb	burn.up
Kabinew	ProperNoun	Kabenau
qom	Adjective	sharp
ulil gebiw	Noun	tree.type
kndoŋw	Verb	tap
ul	Verb	2pl.irr?,2pl.fut.ss
provins	Noun	province
qorai	Noun	old.village
kokob	Noun	grass.type
Matias	ProperNoun	Matthias
tebeŋ	Noun,Verb	carry.over.shoulder,bundle
pnjum	Noun	tree.type
bori	Noun	tree.type
baŋgusrin	Noun	vine.type
ulg	Verb	2pl.fut.ds
kim	Noun	fire
qialub	Adjective	female
tub grua	Noun	tree.type
kambis kbul	Noun	tree.type
su	Noun	place,weather,time,forest
qa pegi	Noun	betelnut.type
ŋgasom	Noun	tree.type
ñagai	Adjective	far
Jumbla	ProperNoun	Jumbla
jar	Verb	flee
galu kanu	Noun	wild.yam
yodu krum	Noun	k.o.arrow
alim magai	Noun	yam.type
sŋgan	Verb	resemble?
aria	Interjection	okay
kalŋgu	Noun	brush.turkey
bjagam	Noun	tulip
kapa	Noun	metal.roof
gilim	Noun	rat
braŋ	Verb	appear?,become,birth?
qodqom	Noun	cloth,white.person
mblal	Noun,Verb,Adverb,Adjective	good,be.good,goodness,well
basil		near
handqar jqalub		
Ku	ProperNoun	Ku,Ku
tqo	Pronoun	2du
kebem nuŋgu	Noun	wild.sugar.type
gumam	Noun,Verb	liver,tire,want?
bdeŋ		
mi	Verb	down,descend
smo mul	Noun	vine.type
biel	Verb	share
ñqre bsqaw	Noun	fig.type
qlaŋeŋ	Noun	snake.sp
huli	Noun	possum
njul	Noun	tree.type
blŋgi	Noun	grass.type
qom	Noun	skin,shirt
qobol	Noun	breadfruit
pared	Noun	creek
kndeŋw	Verb	touch
e	Verb	imp?
jjorŋgor	Noun	tree.type
konai yu	Noun	sugar.type
tmo kanjom	Noun	bean.type
qro	Verb	carry?
sabger	Verb	almost.do
sqo	Pronoun	1du
ubul	Verb	dream
bonem sibu	Noun	tree.type
tdil	Noun	tree.type
maŋgas	Noun	tree.type
madi	Adverb	stay?,later
kumbro	Noun,Verb	behavior,try
powoq	Verb	break
q	Verb	1pl
toŋgu	Verb	cut.into
og	Verb	3sg.fut.ds
Pabu	ProperNoun	Pabu
iri irin	Noun	vine.type
ŋgari	Noun	tree.type
srye	Noun	grass.type
muru		
Gagsil	ProperNoun	Gagsil
qrre	Noun	grass.type
alim	Noun	yam.type
nan	Verb	pl.rpst
qorub sri	Noun	tree.type
kebem koboda	Noun	wild.sugar.type
kaleŋ	Noun	vine.sp?
saŋgi		
lili	Verb	pass
walmun	Noun	bamboo.type
kebem yauqar	Noun	wild.sugar.type
kob	Noun	bamboo
hahayoŋ	Noun	tree.type
gum	Noun	taro
tasol	Particle	but
ñŋgraŋ	Noun,Verb	writing,write
doqol	Verb	cough
ardu		other.side?
min	Verb	stay
tiŋgini	Adjective	straight
humboŋ	Noun	spider
bunom	Noun	dove
ŋgsqoŋ	Noun	fig.type
yawoŋ	Noun	migrant
daram	Noun	drum
lem	Verb	what,do.what,try
yamjar		
sai	Verb	be.greedy
yol	Verb	hit.1sg.obj
kum	Noun,Verb	die,death
ŋele	Noun	sideways,side
ki	Adjective	high
sambi kanu	Noun	yam.type
s	Verb	emph?
ñqre yawoŋ	Noun	fig.type
qmbrem	Noun,Verb	skin,lose.weight
Madaŋ	ProperNoun	Madang
Yamu	ProperNoun	Yamu,Yamu
snjoŋ	Verb	hide
qau	Noun	fat
diksenari	Noun	dictionary
walum	Noun	indoors,room
ŋgusum	Noun	tree.type,vine.type
tub kurwa		
bai		very?
pas	Verb	attach
ŋaŋu	Noun	brush.turkey
qasab	Noun	ear
sambakeŋ	Noun	tree.type
kun	Verb	fill
qatl	Verb	hear?
ñamul	Noun	sister.i.l
nambis	Noun	beach
toqoŋ	Noun	strong.man
mŋgul sambum	Noun	banana.type
y		nmlz
mbolu	Noun	flute
tolu	Verb	be.missing
blai		again
Borosob	ProperNoun	Borosob
go mul	Noun	vine.type
Semi	ProperNoun	Semi
noi		?
kenjreŋ	Verb	hunt
sgi	Pronoun	1pl
ena	Verb	do.thus
kinim	Adverb	just
kujgum	Noun	fern.type
gim	Noun	finger,fruit,egg,arrow
taqal	Noun	slope
alim msreŋ	Noun	yam.type
abu	Noun,Verb	father,care.for,brother
burmanji		
je	Verb	chew?
reuŋ	Verb	swarm
qaqaŋ	Noun	tree.type
bos	Noun	boss
gemeŋ	Verb	worry?
u	Verb	2du.irr?
blei	Noun	palm.type
kurwir	Noun	tree.type
tunduim	Noun	tree.type
kumbur	Noun	smoke
aila		
jorŋgor	Noun	tree.type
lqaw	Verb	jump.over?
lomanji	Adjective,Adverb	very?,true?
kdaŋw	Verb	stab
yeŋgreŋ snji	Noun	tree.type
war	Noun	tree.type
bubanjom	Noun	tree.type
ho	Determiner	prox
qli	Noun,Verb	know,knowledge
g	Particle	ds
laŋun	Noun	haunted.place
huleŋ	Verb	ask
alim koru	Noun	yam.type
a	Particle	lnk
iŋg	Verb	3pl.fut.ds
banjur ŋa	Noun	yam.type
pnaŋgel	Verb	be.stuck
kara	Noun	sweet.potato
qurwa	Noun	parrot.type
Sumai	ProperNoun	Sumai
Buga	ProperNoun	Bougainville
qaloŋqli	Noun	bird.type
smo he	Noun	tree.type
ggelu		
mnen	Verb	stay.sg.prs
yeŋgreŋ bo	Noun	tree.type
jjŋgari mul		
banim	Noun	spear,palm.type,wild.sugar.type
dgu	Adjective	bad
añeŋ	Noun	tree.type
Soqbi	ProperNoun	Soqbi
Kabul	ProperNoun	Kabul
dau tdil	Noun	fig.type
bonem sambi	Noun	yam.type
qaqai	Adjective	slow
par	Verb	break
jŋa	Noun	crab
Dugul	ProperNoun	Dugul
kumoŋ mul	Noun	vine.type
sŋgam	Noun	tree.type
hune	Noun	mistake,problem
marem snjleŋ	Noun	tree.type
mul qian	Noun	fig.type
tar	Verb	lie.on.back
kabum kore	Noun	cordyline
gasi	Noun	tobacco
alim buma	Noun	yam.type
turo	Noun	joint
ge	Noun	uncle
Kwai	ProperNoun	Kwai
hulogmam	Noun	tree.type
pnaŋger	Noun	star
beŋgrem	Noun	foot?
jaŋgur	Noun	tree.type
kede	Adjective	old
niŋg	Verb	3pl.obj
gusluŋ	Interjection	vocable
gumam kndam	Verb	be.angry
mŋgul wiŋgi	Noun	banana.type
ñqre lom	Noun	fig.type
halhalu	Verb	hurry
kol	Noun,Verb	bowstring,string.bow
Sabya	ProperNoun	Sabya
aŋgji		
pikus	Noun	fig
yeŋgreŋ he	Noun	tree.type
Jepen	ProperNoun	Japan
mersem	Noun	palm.type
mŋgul hos	Noun	banana.type
boglo	Noun	tree.type
sabu	Noun	cassowary.plum
karu	Adjective	thick
ko	Verb	break?
sŋeuŋ	Verb	spit.on
qa ŋgusum	Noun	betelnut.type
Kujnum	ProperNoun	Kujnum
taŋar	Noun	in.law
piksa	Noun	movie
klen	Noun	clan
dogu	Noun	tree.type
kir	Noun	chestnut
qumel	Noun	siris.tree
kre	Verb	scratch
brgoŋgoŋ	Noun	plant.type
namar	Noun	child,boy
mb	Verb	?
yeyem	Adverb	quietly
Beyaŋ	ProperNoun	Beyang
Wol Wo Tu	ProperNoun	WWII
usu	Verb	carry.on.head
smbaŋ	Noun	taro.type,tree.type
panibum	Noun	thigh
umbu	Noun	fig.type
kebem sqa	Noun	wild.sugar.type
sambi manus	Noun	yam.type
tulip	Noun	tulip
Se	ProperNoun	Se
snji	Adjective	hardwood
Rabaul	ProperNoun	Rabaul
hembleuŋ	Verb	check
henib		
smbleŋ	Verb,Adverb	dawn,dawn
qri	Noun	bug.type
qqreu	Verb	crawl
mbqa	Noun	leaf
yondu	Adjective,Verb	slow,do.slowly
kepten	Noun	captain
bolu	Noun	bush.god
Qwaŋ	ProperNoun	Male
waiŋa	Noun	provider?
askol	Noun	tree.type
Amerika	ProperNoun	America
gagi	Adjective	black
blasti	Noun	plastic.bag
fopela	Adjective	four
nduru	Noun	large.plate
jiŋgen	Noun	crayfish.sp
yodu	Noun,Verb	bow,seek.bow,penis
kumoŋa	Noun	palm.type
yoqoi	Noun	tree.type
yaqye	Noun,Verb	urine,pee
kondi yu	Noun	sugar.type
alim sŋgleŋ	Noun	wild.yam.type
nabu	Pronoun	3sg.emph
kanjñam	Noun	palm.type
ma	Noun	tooth
Kelsi	ProperNoun	Kelsey
[...]		dur?
kbom	Verb	?,be.close
ulem	Noun,Verb	what,do.what
agim	Noun	eye,money
krum	Noun	shoot
mnjqal	Verb	rejoice
pagu	Verb	embrace,carry.in.arms
Kajgim	ProperNoun	Kajgim
kogu maŋgam	Noun	tree.type
bda	Verb	jump
yakar	Noun	tree.type
n	Verb	2sg,2sg.ss
ŋi yom	Noun	tree.type
ŋamb	Verb	pl.fpst.ss
giñalaŋ	Noun	bird.sp
yem	Verb	sneak
hinib		tall,above
nem	Verb	do.what?
unoŋ jumaŋgi	Noun	wild.yam.type
taun	Noun	town
tareu	Verb	spread
magwa	Noun	plant.type
ge	Verb	?
dqo	Verb	lean.down?
wowoŋ	Noun	vine.type
qaureŋ	Noun	vine.type
gum yona	Noun	taro.type
Kadeŋ	ProperNoun	Kadeng
bjari kbul	Noun	chestnut.type
yu	Noun	sugar
alim galu	Noun	yam.type
li	Verb,Adverb	day.after.tomorrow,become.d.a.t.
ala	Interjection	ah
alim bu huglub	Noun	wild.yam.type
lapun	Noun	old.person
Koinem	ProperNoun	Koinem
kubeŋ	Noun	fishing.net
ŋomb	Verb	1pl.fut.ss
wajlu	Noun	bean.type
mñum	Noun	flower
m	Verb	?
kurgor	Noun	k.o.game
mbsaŋ	Noun	croton
odo	Noun	new.year
gubeŋ	Noun	tree.type
kre	Verb	pull.down
Qode	Noun,ProperNoun	God,white.person
handqar gajur	Noun	vine.type
yaji	Noun	fig.type
yqaŋ	Noun,Verb	feces,poop
jelis	Verb	jealous
koŋ	Noun	tree.type
tbeŋ	Noun	pot
pndowoŋ	Noun	stomach.wound?
banjur	Noun	bat.type
Ida	ProperNoun	Ida
lamdi	Noun	daughter
tamo	Verb	unite?
qoso	Interjection	vocable
titi	Noun	tree.type
mŋgul jgu	Noun	banana.type
quro	Noun	pandanus
tu	Noun	chicken
Kulbu	ProperNoun	Kulbu
tbam	Noun	head
na	Verb	do.that
yaye	Noun	uncle
okei	Interjection	okay
qorub snjleŋ	Noun	tree.type
bym	Noun	brother
qurur	Noun	walnut
pulaŋ		white?
kubom	Verb	be.like
palala	Noun	banana.type
jeŋjeŋ	Adjective	small
Hindamu	ProperNoun	Hindamu
yu malam	Noun	sugar.type
alim armambu	Noun	wild.yam.type
humbaŋ	Noun	tree.type
wewem	Noun	widower
loli	Verb	crawl?
ham	Adjective	new
ñaru	Verb	ruin
gaji	Adjective	dirty
salim	Verb	sell,send
sari	Noun	ginger.type
bim	Noun	vine.type
unoŋ	Noun	genitals
glagol	Noun	vine.type
ggasi	Noun	grass.type
kuro	Verb	scrape
pobor	Noun	lung
smo	Noun	tree.type
sembel	Noun	lips
todom		above
gol	Noun	goal
Ugen	ProperNoun	Ugen
gulgul humbaŋ	Noun	tree.type
malas	Noun	tree.type
kam	Noun	tree.type
qam	Adjective	ripe
kebem poro	Noun	wild.sugar.type
kradi	Noun	plant.type
peu	Verb	hide
dedeŋ	Noun	shadow,picture,spirit
banu snji	Noun	hard.ironwood
awoŋ	Noun	k.o.sibling
kau	Verb	pass,miss
wasu yom	Noun	tree.type
mñaŋ	Noun	axe
meme	Noun	goat
unoŋ	Noun	wild.yam.type
sñagai		far
yawar giŋgi	Noun	grass.type
a	Interjection	ah
boi	Noun	gifts
paipla	Adjective	five
bujrub	Noun	root
aŋgju	Noun	pandanus.type
tg	Verb	2p.?
hrub	Noun	waterfall
Kaŋgso		
teli	Verb	chase
ib	Determiner	loc
waiŋgam	Noun	crocodile
Bjgib	ProperNoun	Bjgib
sgib	Noun	border?
ŋodu	Noun	spirit
Denyel	ProperNoun	Daniel
peu	Verb	clean,wipe
moqlo	Noun	ground
saqu	Adjective	new?
kubeŋ karaŋ	Noun	vine.type
taneŋ	Noun	tree.type,New.Guinea.creeper
tomdeŋ	Noun	wild.sugar.type
jibi	Noun	tree.type
paŋgal	Noun	board
nol	Verb	hit.2sg.obj
huneŋ	Noun	ginger
keker		bring?
kabu	Verb	cover
[...]	Noun	pl?
lowanem	Particle	because
kumeŋ	Verb	fear,be.ashamed
yaqar	Noun	wind
bab	Verb	grow
kmom		
sŋgraŋ	Noun	rafter,post?
a	Interjection	uh
tg	Verb	give.to.2pl,2pl.obj
uri	Adjective	yellow?
kiap	Noun	officer
smabu	Noun	banana.type
yagoni kajiw	Noun	fig.type
Viktoria	ProperNoun	Victoria
kaji	Noun	bristle
ŋa bugumam	Noun	yam.type
pa	Verb	multiply
giŋgi	Noun	grass.type
mblmal	Noun	tree.type
amal	Noun	bean.type
kdi	Verb	extinguish
da	Adverb	together?
mandum	Noun	orphan
i		nmlz
toŋgreŋ	Noun	ginger.type
smbutam	Noun	bug.type
Februari	ProperNoun	February
bom yom	Noun	tree.type
sare	Noun	tree.type
lo	Noun	law
maru	Noun	ritual?
ai	Adjective,Adverb	old,very?,big
lobo	Noun	patriarch
heriri		
yer	Noun	fig.type
gujmo	Noun	fern.type
nabi	Pronoun	2s.emph
moñeŋai	Noun	ancestors
tura	Noun	banana.type
Gili	ProperNoun	Gili
gum	Verb	cond
kebem sebgi	Noun	wild.sugar.type
Gonji	ProperNoun	Gonji
mŋgul jgar	Noun	banana.type
qian kumblu	Noun	strangler.fig
higoŋ	Adjective	crooked
lolom	Noun	elders?
Ostrelya	ProperNoun	Australia
suli	Noun,Verb	cheese.tree,become.tree
nini	Pronoun	3pl
kdum	Noun	under
nau	Adverb	now
Yayani	ProperNoun	Yayani
sensim	Verb	change
sewel		beauty?
doiŋ		
moror	Noun	sand
woga	Noun	banana.type
timun	Noun	kite.type
gebi	Adjective,Noun,Verb	cockatoo,white,become.cockatoo
qaqaw	Verb	do.gently?
bqo	Verb	move.sideways
gaŋ	Verb	do.magic
sambi mise	Noun	yam.type
Humboŋ	ProperNoun	Humbong
Biala	ProperNoun	Biala
giwo	Noun	grass.type
kaŋar	Noun	tree.type
suli qndaseŋ	Noun	fig.type
saŋgun	Noun	tree.type
kiab	Noun,Verb	patrol.officer,be.patrol.officer
ddoŋ	Noun	walking.stick
daŋgur	Noun	petiole
hoqom	Noun,Verb	name,say.name
bambomblum	Noun	vine.type
moñoŋ	Noun	woman
segi	Noun	path.marker
boinem		
Kimbol	ProperNoun	Kimbol
jar	Postposition	with?
he	Verb	yell?
wiŋgi	Noun	tree.type
waŋgom	Noun	tree.type
Nandai	ProperNoun	Nandai
yoqe		
lel	Noun	grass.type
Kialmi	ProperNoun	Kialmi
ulu	Verb	fight
muri	Noun	tree.type
somborñam kbul	Noun	tree.type
yajina	Noun	fig.type
ujem sambi	Noun	yam.type
ñqali	Noun	wife
gerye	Noun	decoration
idi	Noun	gallbladder
yaimbaŋ	Noun	tree.type
taŋgir	Noun	tree.type
gsegseŋ	Noun	tree.type
qrambeŋ	Noun	tree.type
asu bjagam	Noun	tree.type
pff	Interjection	puff
pua	Noun,Verb	buy,payment
qa qabi	Noun	betelnut.type
nŋg	Verb	give.to.3pl,3pl.obj
y	Noun	goal?
duem yu	Noun	sugar.type
jbno	Noun	tree.type
gsam	Noun,Verb	rot,rot
pa	Verb	attach,detach?
be	Noun	grub
sndeŋ	Noun	wallaby
nagi	Noun	firewood
saŋeŋ	Noun	feather
ha	Verb	pierce?
prreŋ	Noun	palm.type
sarub	Noun	scrotum,sack
kabum luaŋ	Noun	cordyline.type
aryo		
gurmo	Noun	signal.drum
traim	Verb	try
seauŋ	Verb	try
kde	Noun	fig.type
maqraŋ gumga	Noun	tree.type
asu	Noun	village.god,flute
gli	Adverb	very
qar	Verb	pry
daŋ	Noun	hand.drum
Gembib	ProperNoun	Gembib
uru	Noun	decoration
Beŋgel	ProperNoun	Benggel
kl	Verb	dig
ŋ	Verb	svc?
sambai	Noun	sugar.glider
ñqre sreŋ	Noun	fig.type
huŋgali	Noun,Verb	work,work
mnjqom tel		lust.after
samsam	Verb	jump.around
glaŋ ñqraŋ	Noun	tree.type
Hayoŋ	ProperNoun	Hayong
snjweŋ	Noun	cockroach
y	Noun	1sg.poss
mŋgul waŋgmo	Noun	banana.type
tultul	Noun	tultul
muñupra	Noun	sweat
jar	Noun	skirt
ŋeŋ	Verb	pl.fpst
twenti	Adjective	twenty
dau	Noun	fig.type
kay	Interjection	thank.you
gru	Verb	run
eŋ	Noun	tongue
grimal	Noun	monkeyfruit
kabu	Adjective,Adverb	elder,very,big
jleŋ	Noun	tree.type
gandaŋ	Interjection	vocable
raun	Verb	wander
ñqre	Noun	fig.type
tudugraŋ	Noun	grass.type
kbol	Noun	action
sŋil gajur		
hulu	Verb	fit
knjalim	Noun	ant
ragu	Noun	k.o.arrow
tliŋ	Verb	birth?
mnŋaŋ	Verb	stay.pl.hab?
jge	Noun	inside,above?
tndaiŋ	Verb	walk?
pdeŋ	Verb	get.up
muñi	Noun	louse
luluai	Noun	luluai
ulil	Noun	tree.type
mal	Verb	ascend,enter
aŋgu		?
eg	Verb	2sg.fut.ds
ñamai	Noun	mother
bal tali	Noun	bird.type
Lei	ProperNoun	Lae
hum	Noun	tree.type
qubu	Verb	swell
no	Determiner,Pronoun	3sg,dist
doŋ	Verb	cut,come.loose,pick
koru	Verb	unite,gather
qumbai	Noun	husband
smub	Noun	nest
alim raw	Noun	yam.type
qrou	Verb	spill?
Banaga	ProperNoun	Banaga
yombu	Verb	steal
Bil	ProperNoun	Bill
po	Verb	split
mondo		
kuuu	Interjection	flute.sound
hegi		below
handqar dila	Noun	vine.type
sekim	Verb	check
gu		caus
was	Verb	watch.over
huaw	Verb	peel
wame	Noun	tree.type
kai	Verb,Particle	neg,finish
wiŋgi mŋgul qam	Noun	tree.type
gum qanju	Noun	biscuit
soŋgon	Noun	tree.type
naintinain	Adverb	ninety.nine
bu	Noun	pig
kunje	Noun	tree.type
janjram	Noun	chest
mondoŋ	Adverb	later
mambla	Adverb	four.days.hence
doqomar	Noun	nape
jqreŋ		
hel	Verb	bear.fruit
balus	Noun	airplane
setri	Noun	shade.tree
semger	Noun	nail
m	Interjection	mm
u	Verb	3sg.obj
ke	Noun	comb
qsa	Verb	whittle
huluel	Verb	turn,change
yua	Noun	mango
ddar	Noun	ginger.type
kñem	Noun,Verb	magic,do.magic
kerŋge	Noun	banana.type
sambi gambaŋ	Noun	yam.type
mŋgul yemel	Noun	banana.type
kreŋw	Verb	shake
mbroŋ	Verb	fly,swell
isoŋ	Noun	sorcerer
kabai	Adjective,Verb	big,be.big
gbom	Postposition	like
ñqre kaji	Noun	fig.type
mei	Noun	which?
Yoŋ	ProperNoun	Yong
qadeŋ	Verb	dance?
jŋgari mul	Noun	vine.type
qareuŋ	Verb	send
mumam	Noun	in.law
mbra	Noun	plant.type
keken	Verb	not.able
qubab	Noun	uncle?
harqaŋ	Noun	reed.type
lalu	Verb	fly,lift?
gugeŋ	Noun	tree.type
o	Particle	voc
qqradeŋ	Noun	shrub.type
had	Noun	hat?
kriesen	Noun	creation
mŋgul qaŋgraŋ	Noun	banana.type
bugu kebem	Noun	wild.sugar.type
gdi	Verb,Postposition	together?,com
Lwal	ProperNoun	Lwal
graqaŋ	Noun	tree.type
moni	Noun	money
sou	Verb	lift
kyakyaw	Noun	k.o.banana
sŋglub	Adjective	single
wiŋgi karu	Noun	tree.type
ñqre gndaŋ		
kombor	Verb	tie
mŋgin	Noun	back
bileŋ	Noun,Verb	light,shine
Mabluk	ProperNoun	Mabluk
ne	Particle	top?
kuji	Noun	testicle,genitals
jagai	Adjective	far
lus	Verb	lack
Wau	ProperNoun	Wau
Don	ProperNoun	Don
jojom	Adverb	near
Raikos	ProperNoun	Rai.Coast
Kanoŋ	ProperNoun	Kanong
kenjeŋw	Verb	cut.up?
kyaŋ	Verb	hit.pl
kalil		all
snjleŋ	Noun	tree.type
Taun	ProperNoun	Taun
kar	Noun	car
hri	Verb	pray
majeŋ	Verb	argue
todu	Noun	cucumber,pumpkin
sanem	Noun	palm.type
qumni	Noun	husband
kesa	Noun	banana.type
mbqa tum	Noun	plant.type
sndeŋ kuwi	Noun	nettle.vine
bdqol	Verb	come.off
Taboli	ProperNoun	Taboli
lelemb		how?
aji	Noun,Verb	coconut,become.coconut?
soŋgu	Noun	rack
ribes	Verb	go.backwards
gle	Adverb	maybe?,any?
daleŋ wagye	Noun	bat.type
Namoŋ	ProperNoun	Namong
leŋ	Noun	bird.sp
seŋgi	Noun	tail,trailer
sum	Noun	charcoal
sri	Noun	tree.type
sapotim	Verb	support
kiŋgi	Noun	fig.type
qraŋ	Verb	prop?
Usub	ProperNoun	Usub
dalili	Verb	pass?
imbri	Adjective	cold
marmar	Noun	tree.type
kumjeŋ lom	Noun	tree.type
gum tmo ŋalub	Noun	taro.type
qajbi	Adverb	three.days.hence
Priska	ProperNoun	Priska
deu	Verb	be.happy,be.straight
Ilai	ProperNoun	Ilai
huli bqali humbaŋ	Noun	tree.type
b	Postposition	loc
waqar	Verb	focus.on?
Ayaŋ	ProperNoun	Ayang
yau	Noun	lie
nambar	Verb	think?
igeŋ	Noun	swamp,lake
hulgub	Noun	stomach
Snaq	ProperNoun	Snaq
wabim	Noun	grandfather.2/3
sboŋ		
o	Verb	3sg.opt?
waji	Verb	pretend,deceive
kuwi mbramu	Noun	nettle.tree
gndaŋ	Verb	strong,be.strong
prra	Verb	tear
jqalub	Adjective,Noun	blood,red
tumbym	Noun	sister
tui	Verb	give.to.3sg
[...]	Noun	?
Koru	ProperNoun	Koru
ga	Noun	sap
sibu		?
tabro	Verb	hold.together?
qneŋgoŋ	Adjective	small
Boŋgu	ProperNoun	Bongu
hrwar	Noun	tree.type
Quliw	ProperNoun	Quliw
qneŋ		small
sg	Verb	1pl,1pl.ss
Gada	ProperNoun	Gada
pobu	Noun	tree.type
bal	Noun	wild.breadfruit
Krab Jqalub	ProperNoun	Krab Jqalub
manji	Adverb	very?
krokro	Noun	tree.type
tegem	Noun	tree.type
Bbgoŋ	ProperNoun	Bubugong
won	Particle	neg.fut
tndroŋ	Verb	pick.many
bul	Verb	turn
basket	Noun	basket
qreb		take.all?
dumbun	Verb	carry.on.stick?
u	Noun	garden
yom sambi	Noun	yam.type
re	Noun	web
ñŋglaŋ	Adjective	wavy
qa wil	Noun	betelnut.type
mŋgom	Noun	back
laulau	Noun	tree.sp
taitim	Verb	exert
qlai	Verb	many,be.many
bqali	Adjective,Verb	bad,do.severely,worsen
ablaŋ	Noun	cousin
qriqes	Verb	scoot
sagu	Noun	tree.type
e	Verb	svc?
Mbrsikabol	ProperNoun	Mbrsikabol
hura	Verb	break.open
gwoŋ	Particle	neg.fut3
dmgeŋ qom	Noun	vine.type
qan	Verb	down,go.down
gumbu	Noun	cheek
ŋai	Verb	deny
anjreŋ	Verb	touch
wqai	Particle	neg
hagar	Noun	palm.type
nanar	Adjective	crazy
diŋgin gebiw	Noun	vine.type
biged	Verb	disobey
Jagar	ProperNoun	Jagar
kadeŋw	Verb	shake
qul	Noun	bag
aŋeleŋ	Verb	look.sideways?
sŋil	Noun	pandanus.type
qamben jagbu	Noun	tree.type
udu	Noun	digging.stick
kina	Noun	kina
labi	Noun	strap
jal	Verb	sit
amuŋ	Noun	father,brother
kaleleŋ	Verb	seesaw?
sndemalam	Noun	sugar.type
quŋgroŋ	Verb	make.noise
snjleŋ huyim kabai	Noun	tree.type
kubaumo	Noun	plant.type
i	Verb	1sg.obj
hauro	Verb	be.hungry
hulogmam gebiw	Noun	tree.type
gsim	Noun	knife
kuroŋ	Noun	clan
jmbaŋ ñob	Noun	grass.type
yago	Verb	dive?
pnnaŋ	Verb	hit
i	Interjection	ouch
ŋglaŋ	Noun	brain
qoqobol	Noun	vine.type
knduŋ	Interjection	knock?
gindiŋ	Interjection	vocable
mal	Noun	loincloth
doŋ	Noun	vine.type
maqum	Noun	tree.type
kubur	Noun	tree.type
neŋ	Verb	think.of
saikoŋ	Verb	carry.across.body
dau lom	Noun	fig.type
maiŋgom	Noun	plant.type
kñaŋ	Adjective	dry
srodu	Verb	scoot
plaŋ	Noun	flame
yi	Verb	1s.obj
bonem	Noun	tree.type
gum sembri	Noun	taro.type
kiŋgi sreuŋ	Noun	fig.type
ñqalim	Verb	itch
grmo ddoŋ	Noun	vine.type
silwil	Noun	tree.type
qaqru	Verb	uproot
la	Verb	talk
krab mul	Noun	vine.type
jŋgai	Verb	touch?
sambi	Noun	yam
meqom	Noun	jaw
qndindi	Verb,Interjection	squeak,squeak
tau	Postposition	com
mundqor	Noun	bean.type
qa saqu	Noun	betelnut.type
nele	Adverb	on.side,look.sideways
yoworqama	Noun	k.o.spear
rero	Noun	wagtail
sumbri	Noun	wild.banana
yagoni	Noun	fig.type
kanjom mul	Noun	vine.type
mŋgul wajlu	Noun	banana.type
kalsa	Noun	culture
ŋadu	Noun	tree.type
timbi	Pronoun	2pl.poss
em	Interjection	right
soru	Noun	grille
Sarub	ProperNoun	Sarub
nau	Adverb	like?,also?
qasrau	Verb	carry.piggy.back
pemli	Noun	family
taŋgin	Verb	secure?
Igreb	ProperNoun	Igreb
paim	Verb,Interjection	bang,crash
agu	Noun	middle
gori gajur	Noun	paint.tree.type
na	Interjection	and
qmblom	Adverb	noon?
blesiŋ	Noun	blessing
ŋgera	Noun	bamboo.type
irin	Noun	vein
Goŋgor	ProperNoun	Gongor,Gongor
ka	Particle	neg?
komboŋ	Noun	fig.type
kabum palu	Noun	cordyline.type
Sawo	ProperNoun	Sawo
ŋayu	Verb	dislike,forbid
slalum	Adjective	old
sele smbaŋ	Noun	taro.type
bere		
Kawa	ProperNoun	Kawa
haurou		
uji	Noun	moss?
sambom	Noun	area
yu blai	Noun	sugar.type
sab	Noun	wing,roof
huyi	Adverb	yesterday
ujem gsim	Noun	grass.type
gulgul	Noun	shellfish
rumañiŋ	Noun	vine.type
tulim	Noun	tree.type
lu		?
kulbum	Noun	tree.type
lom	Adjective	good,true
ñañge	Noun	banana.type
ggeli	Noun	tree.type
hiri		
bobgoŋ	Noun	vine.type
lamjar	Noun	girl
yeo	Interjection	don't,no
q	Verb	svc?
kastam	Noun	custom
kulgol	Noun	k.o.game
qoru yua	Noun	mango
handqar	Noun	vine.type
kegleŋ	Verb	look.down
qsqo	Verb	play
uri	Noun	bundle
siŋeŋ	Noun	saliva
pua	Noun	vine.type
qaju	Verb	shoot
bqor	Verb	crouch
qula	Noun	turmeric
wiŋgi kumu	Noun	tree.type
digi	Noun	border
Yamban	ProperNoun	Yamban
an	Verb	prs
qa		hear?
neu	Verb	?
mam seŋgi	Noun	reed.type
dualu	Noun	hornbill
kial	Noun	kava
ŋgdab	Noun	son.3.poss
mani		up
sikstin	Noun	sixteen
kambeŋgim	Noun	tree.type
qñoŋ	Verb	shake
moideŋ	Noun	bamboo.type
pobu ñam	Noun	tree.type
qurur gum	Noun	taro.type
jijei	Noun	deejay
paiga	Noun	banana.type
Kaspar	ProperNoun	Caspar
Boimbi	ProperNoun	Boimbe
heri	Verb	serve,pour
so	Verb	go,tell.story?
qa umbu	Noun	betelnut.type
jgu	Noun	cassowary
smou	Noun	banana.type
ig	Verb	1sg.fut.ds
argim	Noun	rib
aŋji	Noun	tree.sp
Mak	ProperNoun	Mark
amani	Noun,Verb	top,be.high?
toŋgu	Noun	bamboo.type
tmbal	Noun	vine.type
glaŋ	Noun,Verb	side?,go.thus
jqal	Adjective	clear
Qodei		
ai		big,very
ŋondom	Noun	bone
yaru	Adjective	soft
umbu gebiw	Noun	fig.type
rausim	Verb	remove
qawar	Noun,Verb	shoulder,fork,carry
noqo	Pronoun	3du
wi	Noun	sore
kem	Verb	carry.on.shoulder
kabum	Noun	cordyline
qaŋ	Verb	draw.bow
tmbe	Noun	plant.type
ŋasum		before
sŋil uri	Noun	pandanus.type
bum	Noun	bottom,source
joblu	Noun	blessing
pe	Verb	hide
masalai	Noun	spirit
Regu	ProperNoun	Regu
qaser		
boimbon	Noun	tree.type
fatpela	Adjective	fat
Niŋgaŋ	ProperNoun	Ninggang
qou	Particle	neg.imp
ese	Interjection	thats.right
yedi graŋ	Noun	tree.type
Añel	ProperNoun	Anyel
mŋgul iri irin	Noun	banana.type
Goŋ	ProperNoun	Gong
palum	Adjective	muscular
tub	Noun	tree.type
krdu sreuŋ	Noun	tree.type
ñaŋ	Noun	mother
bubusi	Noun	grass.type
dubu		below
Imbu	ProperNoun	Imbu
ŋeseŋ	Verb	grow
gau	Verb	attach?
baimban	Noun	tree.type
bru hobgol	Noun	plant.type
ggdol	Noun	tree.type
mai	Pronoun	who
tomnu	Noun	surprise
bem	Verb	dance?
mbqoli	Noun	middle
qamgo		
taneŋ mul	Noun	vine.type
bjagam gajur	Noun	tulip.type
mŋgul yeŋgreŋ	Noun	banana.type
kabŋgam	Noun	tree.type
qama	Noun	k.o.arrow
alim graru	Noun	yam.type
Samson	ProperNoun	Samson
gum koibe	Noun	taro.type
kebem wowa	Noun	wild.sugar.type
q	Verb	3sg,3sg.ss
mari	Noun	tree.type
raqum	Noun	car,crab
bu toqo	Noun	tree.type
momo	Noun	father
sŋgaŋ	Noun	tree.sp
boqlob	Noun,Verb	shoot,sprout
ŋoŋg	Verb	1pl.fut.ds
jaji	Noun	ancestor,grandparent
Bauri	ProperNoun	Bauri
wau	Verb	cheer
ggum	Adjective,Noun	heavy,problem
yaŋ	Noun	ancestor?,mushroom
breu	Verb	throw.pl.obj
gom	Noun	crumb
ŋgrŋar	Noun	tree.type
mŋgul yeŋgreŋ konoba	Noun	banana.type
Dula	ProperNoun	Dula
kbom	Adverb	somewhat
hu	Verb	blow
truq	Verb	lie.on.stomach?
koi	Verb	badly?
Koro	ProperNoun	Koro
hreŋ	Noun	tree.type
kolom	Noun	leg
hedi	Noun	creation
kŋgñeu	Verb	collapse
mbrai		
kebembrum	Noun	tree.type
Seseq	ProperNoun	Seseq
sulaŋ	Noun	sky
mbrum	Noun	debris
magwai	Noun	plant.type
mblon	Noun	brush.turkey
waŋgaim	Noun	crocodile
rsag	Noun	backpack
kda mul	Noun	vine.type
tel	Verb	put
yuri	Noun	week
sndoŋ	Noun	tree.type
kebem sŋgaru	Noun	wild.sugar.type
Qunji	ProperNoun	Qunji
walemb	Noun	bamboo.type
sambi gobe	Noun	yam.type
kum	Noun	grass.type
Jilim	ProperNoun	Jilim
hambraŋ	Verb	untie,be.loose
jel	Verb	step.on
[...]		?
tmo	Noun	man
mŋai	Noun	brother?,friend,co.wife
kndum	Adjective	new
hodo	Adjective	light
gambeŋ	Noun	caterpillar
gboŋgri	Noun	bird.sp
walem		
marem jo	Noun	wild.pepper
mal		up
qa umbumbre	Noun	betelnut.type
kaqaŋ	Noun	tree.type
q	Noun	?
gajur	Adjective	red
samu	Noun	famine
kore	Noun	tree.type
kndam	Verb	hurt
ugim	Noun	seed
kndul	Noun	bamboo.type
jueleŋ	Noun	tree.type
s	Verb	1pl.ss
tgi	Verb	2pl.obj
eb	Verb	2sg.fut.ss
lam	Noun	boy,son,child
srin	Noun	vine.type
kob gsim	Noun	bamboo.type
ana		
gilñam	Noun	path
bjqa	Verb	fall
aumoŋ	Noun	k.o.sibling
taŋ	Verb	wash
gursi	Noun	corn
ad		
rait	Adjective	right
tenem	Adverb	completely
yaguñi		
hurom	Noun	hole
huli bqali	Noun	possum.type
gum snadu	Noun	taro.type
glawŋ	Verb	break
krdu kaju	Noun	tree.type
bqarai	Adverb	very?
yabi	Pronoun	1s.emph
olol	Verb	be.loose
wau	Noun	tree.type
smbar	Noun	tree.type,vine.type
ssur	Noun	tree.type
mŋgul amda	Noun	banana.type
qamben	Noun	doughwood
madibor	Noun	palm.type
uqo uqo	Noun	vine.type
unoŋ	Noun	place?
qai	Particle	exph
yu kulbu	Noun	sugar.type
gumbym	Noun	daughter.3.poss
kendi		?
koko		very?
Banji	ProperNoun	Banji
ñem		?
tdbeu	Verb	plant.pl.obj
blu		again
tambram		short?
seŋ	Verb	break.off
sew	Verb	try
nal	Noun	day,time
knjan	Verb	chew
sambi didibu	Noun	yam.type
pinjum	Noun	plant.type
uqan	Verb	be.cooked,shine,burn
suli yom	Noun	tree.type
hm	Interjection	grunt
Kaliku	ProperNoun	Kaliku
sreuŋ	Adjective	?
asir	Verb	pinch
snaŋgur yom	Noun	tree.type
kin	Verb	sleep
bu komboŋ	Noun	tree.type
nun	Verb	feed
kial mul	Noun	vine.type
klim	Verb	smell
ha	Verb	drop,let.go
uleŋ	Verb	flee
qa	Verb	fut
bjari	Noun	chestnut
ta	Verb	tie
doqol mul	Noun	vine.type
manu	Noun	top
taŋ	Interjection	bang
bniŋgur	Noun	tree.type
ŋam	Verb	?
prqa	Verb	arrive?
kumbu	Noun	sugar.glider.type
kala	Noun	color
bsaŋgu	Noun	tree.type
komblom	Noun	neck
daleŋ mul	Noun	vine.type
yom kuwi	Noun	nettle.tree
hodu	Verb	pour
daleŋ suanjir	Noun	bat.type
huyim	Noun	leaf
kumunŋgraŋ	Noun	tree.type
Kior	ProperNoun	Kior
qa warabu	Noun	betelnut.type
kebem tmo lugu	Noun	wild.sugar.type
beŋ	Verb	up,ascend
manu	Noun,Verb	stone,become.stone
leta	Noun	ladder
namur	Verb	be.tasty
Jalum	ProperNoun	Jalum
ql	Verb	2pl.imp,2pl.fut.ss
belo	Noun	bell
gasu	Verb	carry.on.shoulder
walam	Noun	mens.house
Bol Qli	ProperNoun	Bol Qli
akekleŋ		
njul huyim ssaŋgai	Noun	tree.type
qradeŋ	Noun	crab.sp
ausig	Noun	hospital
Yen	ProperNoun	Yen
dila	Noun	vine.type
tou	Noun	elder
jgar mul	Noun	vine.type
Dumbu	ProperNoun	Dumbu
grqos	Noun	tree.type
sgñe	Noun	bamboo.type
gum lamtar	Noun	taro.type
sabor haru	Noun	tree.type
mnjraŋ	Noun	plant.type
maiŋgom hilum	Noun	plant.type
malin	Noun	tree.type
Qamboŋ	ProperNoun	Qambong
bom	Noun	sago
kri	Verb	compl
palam	Noun	k.o.arrow
galu	Noun	wild.yam
tlambu	Noun	palm.type
jaru	Verb	ignite
yagoni bsqaw	Noun	fig.type
ayaŋ	Noun	manioc
imb	Verb	3pl.fut.ss
ain	Noun	spear
kadel	Noun	seashell,banana.type
sari	Verb	look.for
kabñam		all
bla		again
i	Determiner	loc?
qli	Noun	bigman?
sabor	Noun	axe
Sami	ProperNoun	Sami
mamse	Noun	praying.mantis
bsqa	Adjective	smooth
Laloq	ProperNoun	Lalok
he	Adjective	softwood
yu baŋgim	Noun	sugar.type
jar qobol	Noun	tree.type
jmbulam	Noun	tree.type
mbsaŋ gajur	Noun	red.croton
bsa mul	Noun	vine.type
kuru	Noun	gunpowder.tree
Warqli	ProperNoun	Warqli
mbe		
sqa malin	Noun	tree.type
qrwa	Noun	bird.sp
mŋgul	Noun	banana
yakar lom	Noun	tree.type
hegleŋ		this.side
gam		some
kabum pnjum	Noun	cordyline.type
alim huneŋ	Noun	yam.type
Junya	ProperNoun	Junior
menebu	Noun	tree.type
qaseŋ	Noun	mosquito
ambris	Noun	melon
bleŋ	Noun	chest
ñqali	Pronoun	3du.poss?
huñum	Noun	name
greŋ	Verb	crawl
walmun kaji kai	Noun	bamboo.type
dwem	Noun	bird.of.paradise
bri	Verb	arrive
ni	Pronoun	2sg
kunjo		
Yali	ProperNoun	Yali
kuru	Verb	bear?
snjil	Adjective	red
qamam	Noun	fish
kambis	Noun	tree.type
adoptim	Verb	adopt
sremu	Noun	betelnut.type
tini	Verb	give.to.2sg
gumam bqali		disappointed?
gum kali	Noun	taro.type
baqrum	Noun	dollarbird
puparu	Verb	break.pl
weri	Verb	perish
misineri	Noun	missionary
