mana	Noun	louse
qe		plan?
qasan		hurry
gavman	Noun	government.TP
aŋgr	Verb	put.3p
bujer	Noun	tree.sp
guguji	Noun	piece
abreg		
gin	Verb	come
qain	Noun	mosquito
Bilbil	ProperNoun	Bilbil.place
fam	Noun	farm.TP
ebib		hurry?
wab	Noun	pot
kriŋa	Noun	woman
blut	Noun	blood.TP
raruŋgamba	Noun	leak.water
qaqein		prayer
gaŋgu	Noun	wind.fish
gari	Noun	cloth
tar	Verb,Adverb	up?,put.up
Melamu	ProperNoun	Malamu
oj	Verb	touch
Kamu	ProperNoun	Kamu
gujit		
sel	Noun	vine
Managate	ProperNoun	Managate.place
injalum	Pronoun	23d.poss
rait		right?.TP
wau	Noun	grandfather,grandchild
arenen		?
beslan	Verb	23d.prs.hab
basa	Verb	be.finished
tem		
gu	Verb	cook
qani	Adjective	true
baqla	Noun	exchange.partner
suqle	Noun	bone
gabra	Noun	stream
baru	Verb	shake.hands
amal	Noun	snake
beben	Verb	23ns.hab
gul	Noun	string
aŋam	Noun	tree
qarqos	Verb	block
serereq	Verb	sizzle
nonoi		small,closeby
bor	Noun	salt
wi	Noun	lime,ashes
mub	Noun	mouth
you	Noun	sore
garam	Noun	moon
i	Demonstrative,Postposition	prox?,loc
ŋoqa	Noun	wife.3s.poss
ujagla	Noun	navel
ŋamku	Verb	lie.face.down
en		?
wemun	Noun	clan
America	ProperNoun	America
abrig	Verb	hold,grab
neba	Verb	look.at.1s
laŋgu	Adverb	landward,above
ñi	Pronoun	2s
tasol	Interjection	but
bara	Verb	shake.hand
yig	Pronoun	1pi
nj	Verb	3ns.obj
popla	Verb	open
peu	Verb	try
yekram	Noun	bug.sp
pat	Noun	stone.axe
ho	Interjection	hello,so
ario	Interjection	ario
pag	Verb	hide,go.past
sore		sorry
tom		3s.poss?
reŋ		nmzr?
aqreur	Verb	kill.completely
baqala	Noun	frame?
gogumu		
qabul	Noun	breadfruit
aguquji	Adjective	short
ju	Verb	make
yau	Noun	betel.pepper
mesen	Verb	12s.prs.hab
aguguqu	Adjective	short.redup
d		?
kaŋgruŋ	Adjective	big
oda		correct?
ŋis	Verb	wash
Waŋ	ProperNoun	Wang
dundeqla	Noun	girl
Tuag	ProperNoun	Tuag
qa		color?
areŋ	Noun	thunder
guñalaŋ	Noun	black.cockatoo
mur	Verb	1ns.??
sena	Noun	taro
geil	Verb	carry
alili		two?
ñil	Pronoun	2d
tambriŋ	Adjective,Verb	afraid?,fear
d	Verb	go,come,go.in,return
qi		
oboqt	Verb	open
lokim	Verb	lock.TP
rausim	Verb	get.rid.of.TP
lain	Noun	plantation,family.TP
jige		afternoon?
sirau	Noun	knife
gumbliqa	Noun	boy?
meme	Noun	goat
yamba	Adverb	tomorrow
bul	Noun	pig
Boŋgu	ProperNoun	Bongu
qalue		female?
awul	Noun	tree.sp
la		stupid
injoŋ	Verb	be.busy
a	Particle	ah
dam	Noun	step
kamanji	Noun	game.animal,animal?
qar	Noun	fence
añiboro	Adjective	big
mum	Verb	1ns.prs,1ns.ifut
Keti	ProperNoun	Cathy
[...]		emph?
ban	Verb	23ns.rpst/fut,23ns.fut,23ns.rpst
meq	Verb	2s.prs
nanaji	Pronoun	3p.emph
qoki	Noun	bird.sp
Asel	ProperNoun	Asel
Biwo	ProperNoun	Biwo
eteu	Verb	?
si	Noun	nail
sur	Verb	fall.down
tambram	Noun	source?
qasañe	Adverb	quickly
rar	Noun	game
tatu	Verb	awaken
tavir	Noun	chest
paqariŋ	Verb	turn
kere	Adverb	enough?,all,well.adv
Moksen	ProperNoun	Moksen
mal	Noun	tree.sp,loincloth
keneŋ	Adjective	little
al	Verb	open
bosboi	Noun	boss
ogen		
qaugogo	Interjection	I.like.it
utua	Verb	adopt
anju		
qutuluŋ	Verb	be.frightened
aq	Verb	irr,irrːdes,irrːfut,irrːhort,irrːabil,irrːpur,irrːobg,irrːimp,irrːproh,irrːatmt,irr:pres.hab,irr:hypo,irr:cond,irr:inf,irr:supp,irr:dub,irr:so.that,irr:advis
alam	Noun	yam.sp
naji	Pronoun	3p
njam	Noun	23ns.poss
ko	Noun	neck
uqule	Noun	problem,weight
maŋamaŋau		various
ur	Verb	3s.obj?,?
bi	Noun	feces
mine	Noun	stomach
nal		now
ŋamqabut		?
nareŋ	Noun	hornbill
baqain	Verb	run
qaboqe	Adjective	full
Yomba	ProperNoun	Jomba
aqle	Noun	?,neck
tenemu		straight
or	Noun	heart
aqa	Adverb	here,now
tapor	Noun	iron.axe
tabir	Noun	plate,money,bowl
piqpaq	Verb	spill?
sare		old
etir	Verb	look.down
yayali	Pronoun	1di.emph
toror	Verb	encounter
win	Noun	turtle
sa	Noun	dog
mete		first
basis		barge?.TP
ala	Verb	distribute
toum	Noun	picture
moro	Adjective	old
qabau		other.side?
Gwaŋ	ProperNoun	Gwaŋ
qawal	Noun	tree.sp
soq	Verb	lift
namediŋ		old
alue	Noun	point.geographic.feature
as	Noun	bird
maski	Interjection	nevermind
sogal	Adverb	far
aqale		ripe
nabal	Noun	time,day
jegara		all
poŋ	Verb	clear,break,think?
Kaliku	ProperNoun	Kaliku
kampani	Noun	company.TP
[...]	Verb	dur?
gil	Verb	?,fly?
utri	Noun	platform?,under
ola	Verb	walk,go.around
quse	Noun	body
at	Verb	put,do,build,leave,prepare
olam	Noun	butt?,inside,hole
saman	Noun	outrigger.TP
nono	Verb	get.close.to
am	Noun	mother,mistress?
agle		?
damu	Adjective,Noun,Adverb	inside,intens,true
ab	Noun	father
em	Verb	2s.rpst/fut,2s.rpst,2s.fut,3s.fut??,2s.imp?
toura	Noun	sail
qeil	Noun	decoration
Soŋgum	ProperNoun	Songum
kosoŋgor	Noun	voice
mam		hungry
sasam	Noun	shark
lat	Verb	forget
qaboq	Verb	be.full?
nau	Noun	bamboo
gatuŋgu		(magic.word)
qur	Verb	cut
qau	Noun	betelnut
mumun		1ns.prs.dur?
binja	Noun	split.wood?
oq	Verb	go.up
sande	ProperNoun	Sunday.TP
are	Noun	liver
añiñi	Adjective	big.redup
alen	Adverb	right.now
lalai		slow
rasia	ProperNoun	Russia
quli	Verb	hide
bil	Verb	mark?,stop
yaya		send
osale	Verb	remove,unfold
kadei	Noun	friend
mablum	Noun	flying.fox
aliw	Adverb	day.before.yesterday
Garim	ProperNoun	Garim.place
qurat	Verb	finish
e		q
wisil	Noun	weasel?.TP
qaly		
iŋgi	Noun	food
eben	Verb	23ns.fpst
añi	Adjective	big
mar	Verb	talk
dabu	Noun	side
yalum	Pronoun	1di.poss
eqen	Verb	3s.prs?,prs.perf?
it		caus
i		?
Yambambu	ProperNoun	Yambambu.snake
skul		school
man	Noun	man.TP
sub	Verb	push.TP
qeij	Noun	cockatoo
wur	Verb	finish
wal	Noun	sea
bekim	Verb	respond
pam	Particle	(onomat.for.flying.fox)
wawasa	Noun	ancestor
Rumbau	ProperNoun	Rumbau
gamba	Noun	coconut.shell
briŋti	Adjective	other
Guabe	ProperNoun	Guabe.place
sel dul	Noun	phone (vine vein)
i	Verb	give?
temur	Noun	wind
am	Interjection	um?
dodo	Adjective	little
qaubi	Adjective	white
piliŋ	Noun	clear
akai	Noun	grandchild,grandparent
agrag	Verb	be.annoyed.at
ande	Demonstrative	this
uli		hide
enes	ProperNoun	Enes.name?
qoqoros	Noun	firefly
surmai	Noun	fish.sp
kolmen	Noun	Coleman.lamp
memes	Verb	12s.iter.r.ss?
uru	Verb	fly
jiglain	Noun	k.o.pandanus
sisi		news
neŋgereŋ	Noun	school
gai	Noun	uncle
Yabui	ProperNoun	Yabui
ŋg	Verb	2ns.obj
bele	Noun	place
nal	Verb	change
sait	Noun	site.TP
dadal	Noun	plant.sp
oqgin	Verb	come.up
debul	Noun	thigh
qoraŋ	Noun	small.intestine?
ulul	Noun	sand
qapou	Noun	?
gogmu	Noun	village
betaqt	Verb	tackle
tag	Verb	fill.up,scoop
kokorla	Interjection	rooster.onomat
alwe	Noun	sharp,point
kuli	Noun	great.great.grandfather
umbuq	Verb	fall.down
Toya	ProperNoun	Toya
musen	Verb	1ns.prs.hab
ajai	Noun	grandmother
quji	Adjective,Adverb,Postposition	one,together,same,with
Gumbu	ProperNoun	Gumbu.place
injeroq		make?
aq		
sisiu	Noun	personal.information?,state.of.being
[...]	Adjective	iter?,pl?,emph
saqarum	Noun	stone
qaigi	Noun	tooth
juqa	Noun	cassowary
und		that
orait	Particle	okay.TP
isroŋu	Adjective	red
raba	Noun	rubber.TP
Korenduk	ProperNoun	Gorendu
milyaqun	Noun	brush.turkey
sumbi	Adjective	black
bek	Verb	respond
qawe	Adjective	new
isoŋ	Noun	spirit
ndam	Noun	3s.poss
usul	Verb	shake
namur	Noun	fat
qouna	Adjective	old
bul	Verb	turn
mi	Verb	talk.to
neŋgut	Adjective	cold
polort		
bokonom	Noun	meat
joŋ	Verb	flutter.around
naram	Noun	bundle
quribi	Postposition	with,all,together
dona	Noun	bone.tool
yi	Noun	water,beer
keŋeneŋ		
jaqanam	Noun	crayfish
qom	Noun	fog
beg	Noun	bag.TP
si	Verb	be,sit,stay,have
doŋ	Verb	break.off
qei	Noun	butt?/thing?
egau	Verb	ifut?
ne	Verb	see
ib	Verb	2ns.imp
qaqali	Noun	look
sawe	Verb	know.TP
iw		hab?
Mas	ProperNoun	Mas
tar	Verb	lie.on.back
poq		boil
aŋu	Verb	stand.up
ŋamqu		?
siw	Verb	laugh
qosiw	Noun	wrist?
mey	Verb	sit
esen	Verb	3s.prs.hab
maliŋ	Noun	dawn,time
ŋamgi	Noun	eye
ailan	Noun	island.TP
Jemen	ProperNoun	German
deŋdeŋ		straight
bus	Verb	3ns.?
momor	Adjective	childish
boyo	Noun	dessert
bere	Noun	top
moga	Noun	banana
ou	Verb	answer
undi		other.side?
momaŋgamba	Noun	forehead
ñuqulam	Noun	leg.mark?
priq		shake
away	Verb	buy
bane	Noun	branch
miŋ	Adjective	dark
nam	Noun	2s.poss,1s.poss?
ñeñik	Noun	fly
bale	Noun	root
siwoni	Noun	fruit.sp
eo	Noun	loc
ari		
qoqoleti		four
oyu	Noun	butt
soqam		stick?
jeraw	Verb	run,go.separate.ways
er	Verb	??,dur?
buk	Noun	book.TP
sawe	Adverb	there
Bog	ProperNoun	Bog
papai	Noun	papaya
Qurenduk		
oŋgin		return/come
moqal	Noun	below
ŋaŋgli	Noun	woman
kaluŋ	Noun	kangal.TP=?
sibol	Noun	wallaby
gour	Verb	throw
gaga	Verb	?,be.angry.at
yar	Noun	year.TP
kawai	Noun	old.person
yiyigi	Pronoun	1pi.emph?
olsem	Adverb	thus
0	Verb	take,do,hold,marry,be?
moŋdamu	Noun	land
e	Verb	ser
m		?
ot	Verb	trip.TP
tir	Verb	?,land
bolumboslo	Noun	toad
taia	Noun	tire.TP
ta	Verb	dance?
sawa	Noun	sea.TP,village?
n	Postposition	agt,emph,pat.top,gen?,instr,top
bambariq	Verb	flap.wings
ñ	Verb	sleep
ge	Noun	digit,fruit
sin	Postposition	instr?
eriŋ	Verb	avoid
jerau	Verb	run.away
qaun	Verb	push,swim
tuq	Verb	capsize
qobuŋ	Noun	canoe
daqne	Noun	daughter
utu	Noun	piece?,remainder
soqol	Noun	breadfruit.egg?
timbaŋ	Verb	hold.fast
qaigi	Noun	sap
aqan	Noun	wife
ana	Verb	give.to.3d?,give?
bade	Noun	wing,side
qaqun	Noun	basket
qos	Verb	fasten
neñiqra	Noun	trash
jeŋ	Noun	sugar
qoqol	Verb	chase.out?
uqole		heavy
bola	Noun	genitals
tumbaŋ	Verb	carry
bisañi	Noun	bush
Madaŋ	ProperNoun	Madang.place
Siroi	ProperNoun	Siroi
ak	Verb	leave
buq	Verb	dig
gom	Verb	search
qanun	Noun	shadow,spirit
beren	Verb	23ns.prs.iter?
ambembliŋ		middle.redup
en		q?
busne	Noun	top
walu	Noun	pumpkin
gere		correct
momaki		little.brother?
qa	Verb	chew?,make.right?
o	Particle	or.TP
miliŋ		lightning
Raikos	ProperNoun	Rai.Coast
gir	Verb	crawl
tat	Verb	do.what
qundi		pl?
duqum	Adverb	just?
jog	Verb	go.inside,put.inside,put.on
yil	Verb	bathe
dan		who?
qaqai	Particle	neg
sapor	Noun	axe
gaba		carry
bisoŋgum	Adjective	naked
bei	Adjective	another
Muar	ProperNoun	Muar
yib		?
qoro	Noun	back
gig	Noun	armpit
jigor	Verb	throw,get.rid.of
qulat	Noun,Verb	boss,watch.out.for
damu	Noun	meat
oler	Verb	go.around
nnn	Interjection	mmm
saqau ge	Noun	k.o.arrow
yi	Verb	move?
agu	Noun	trunk,edge
saqau	Noun	greens,multi.prong.arrow
paqt	Verb	pour
Tapaŋbi	ProperNoun	Tapangbi
nam	Pronoun	2s.poss
eren	Verb	3s.prs.iter?,3s.prs.perf?
gineda	Verb	arrive
waya	Noun	crocodile
otaŋgra	Noun	place.for.putting.pot
Kiñalbu	ProperNoun	Kiñalbu
mun	Noun	festival
buain	Noun	star
gate	Noun,Verb	head,play.war
bisnis	Noun	business.TP
l	Verb	wash?
kansol	Noun	consul?.TP
Korendu	ProperNoun	Gorendu
bokene	Noun	side
tamo	Noun	man
qajiu	Noun	problem
keneneŋ	Adjective	little.redup
aqai	Particle	neg?,?
briŋ		emph
eq	Verb	neg.participle?,pres?
urur	Verb	capsize
Dagaun	ProperNoun	Dagaun
uli	Noun	feathers
nanjam	Adjective	3p.poss
pilim	Verb	feel
le	Verb	kill
dab	Noun	ear
mañim	Noun	sister.i.l
tatawe	Postposition	party?
ŋarog	Adverb	eastward?,over.there?
qabal	Noun	cousin,brother.in.law
konau	Noun	throat
batiti		
wayaŋ	Verb	yell
qoul	Verb	fence.in
dokeneŋ	Adjective	small
praimeri		primary
injroq	Verb	do.thus.still?
sabuk	Verb	be.angry
jiqarqulu	Noun	sweet.potato
jim	Noun	1s.poss
buru	Noun	break.TP
suw	Verb	take.away
enjiŋ	Noun	fat
tutut	Verb	push
qut	Postposition	with.comitative,together,agt?,dat?
albim	Verb	help.TP
mus	Verb	1ns.r.ss
eblan	Verb	23d.fpst
okei	Interjection	okay
wuleu	Noun	sand?
wula	Verb	wake.up
nogam	Noun	sibling
yit	Verb	chase
uru		tie
tot		same
ul	Verb	get.up
al	Adverb	now
aqaqai	Adverb	?,again.redup,all?,just.only,dur?
gugrus	Noun	corn
mued		?,this.place?
qu	Postposition	loc
ŋis	Noun	sweat
u	Noun	penis
Maragum	ProperNoun	Marakum
kuruq	Verb	clean
maliŋ keret	Adverb	always
beb	Verb	23ns.prs
tawi	Noun	loincloth
buntata	Noun	gable.wall
dabo	Noun	other.side
dutagu	Noun,Verb	body,skin
eñel	Noun	angel
ñe	Verb	lay.down
jemble	Adverb	morning
gere	Verb	make?
Kul	ProperNoun	Kul
femli	Noun	family.TP
dole		near?
qemor	Noun	children
gam	Pronoun	1pe.poss
kapo	Interjection	rooster.onomat
guriŋ	Noun	shaft
tartiu	Verb	turn
modarqa	Noun	life?
ey		?
misil	Noun	saliva
Yalo	ProperNoun	Yalo
Qotoi	ProperNoun	God
taim	Noun	time
lagabu		dark
quji		
doqone		near?
ñiñili	Pronoun	2d.emph
toran	Verb	ask
modar	Noun	breath,spirit
buleren	Verb	23d.pres.iter?
bi	Verb	?
qalupti		three
memba	Noun	member.TP
e	Verb	2s.imp
nuŋgai	Adjective	alone
bia	Noun	fire
bisi	Adjective	busy.TP
aria	Interjection	okay
oŋgo	Noun	testicles
aqai	Adverb	back.direction,again?,toward.direction
nambwan		first.TP
dug		
botol	Noun	bottle.TP
your	Noun	k.o.spear
paq	Verb	spill?
aliti		two
ŋelik	Noun	brain
tera		
it	Verb	write
sevi	Verb	think
Ileg	ProperNoun	Ileg
en	Verb	?
j	Verb	?,have?
sambi	Noun	yam
andu	Pronoun	3s
bujruqt	Verb	leave.3s.obj
dub	Noun	forest
gau	Verb	shoot
qombi	Noun	fog
prika	Noun	prika.TP
boboqole	Adjective	bad.redup
kirapim	Verb	awaken.TP
u	Verb	eat
qabrawu		dry?
do	Noun	child,son
Bindaŋ	ProperNoun	Bindang
malel		sit
be	Particle	spec,q,also
tag	Verb	tie
bile		there?
totoum	Noun	picture
ŋwaŋ	Noun	brush.turkey
kamba		?
mambris	Noun	butterfly
aŋ	Verb	be.confused?,go,go.around,open.up
alam	Adverb	now
susu		afraid?
im	Verb	3s.irr?
d		?
Yabob	ProperNoun	Yabob
qal	Verb	thunder?
tatal	Adjective	not.know
kolektim	Verb	collect.TP
gare	Noun	cloth,foreskin
alul	Verb	destroy,get.messed.up
andam	Pronoun	3s.poss
sem		?
taŋ	Verb	collect
aŋgumu	Noun	right.arm
o	Verb	talk.back
pampum	Verb	?
pot	Verb	split
si		?
nal	Noun	day?
Kakara	ProperNoun	Dampier
kalu	Adjective	ugly
taqel	Verb	bend,walk?
biw	Verb	?
wilwil	Noun	bicycle.TP
suŋgli	Noun	baby
gateu		fight
dabuig	Verb	remove
tuŋu	Verb	make
qaqal	Verb	hit,look,found
qaja	Noun	k.o.arrow,spear
magle	Noun	guts,room,inside,belly
jaq	Verb	get,take,bring
tenenem	Adjective,Verb	quiet,straight
gitet	Verb	bend
managruŋ	Noun	nose
naŋgli		
buruq	Noun	flame
barum	Noun	signal.drum
sare	Noun	testicles
tal	Noun	house
asa	Noun	great.grandfather
bon	Verb	?
qaqam	Noun	moon
kajir	Adjective	dirty
añiboroŋ		
iŋg	Verb	give.to.2p
Boŋu	ProperNoun	Bongu
sub	Adjective	old?
tabar	Noun	village,foreign
wab	Noun	kneecap
bubulw	Verb	translate
sen		toward?
alwau	Adverb	day.after.tomorrow
qabraqu		
ina	Noun	grass.sp
sub	Noun	hole,place?
d	Verb	push
mogal	Adverb	seaward?
qwain	Noun	left.arm
video	Noun	video.Eng
prut	Noun	fruit.TP
pu	Verb	blow,fall.down
gatuŋt	Verb	close
mo	Noun,Verb	die,sick
lalbul	Verb	turn
sisi		be.hab?
ma	Verb	call.out
keret		all
an	Verb	3sg.ifut
kenjim	Noun	penis.head
prrqaqad	Verb	come.up.on.other.side?
boqole	Adverb	bad,intens
mubolam	Noun	mouth
mes	Verb	12s.r.ss
kekere		same
Kelsi	ProperNoun	Kelsey.person
dutaqu		
qam	Noun	smoke
lambi	Adjective	many,long.of.time
kaye	Noun	thanks
bula		afternoon
moni	Noun	money.TP
yamban	Noun	bush
ayi	Adjective	old
pagt	Verb	put
suga	Noun	sugar.TP
aim	Verb	2s.fpst
uleo	Noun	beach
ey	Verb	carry
moŋgi	Noun	coconut
daten		how?
ŋ		
opim	Verb	open.TP
batit	Verb	pull
wali	Noun	friend
boam	Noun	sago
qaseŋ	Noun	tool
es	Verb	irr.ss,3s.r.ss,irr:opt?
emun	Verb	1ns.fpst
raŋ	Noun	parent.in.law
gitetu	Verb	give.weight
baqla	Noun	platform,bed
nuji	Noun	island
pulu	Verb	return
Bawin	ProperNoun	Bawin
Maqamsu	ProperNoun	Magamsu.place
lo	Noun	law.TP
eŋgl	Verb	count
ñiñiyi	Pronoun	2s.emph
la	Verb	?,die?
guruŋduŋ	Verb	sound.onomat
yaulbi	Adjective	yellow
nai	Noun	skirt
tenem	Adverb	straight,very
gumbeli		
dib		dusk
nambre	Noun	bundle
bajin	Verb	steal
augul	Verb	fall
n	Verb	carry?
Australia	ProperNoun	Australia
Aqalu	ProperNoun	Aqalu
koken	Verb	spill?
genim	Noun	possum
e	Verb	?
qa	Postposition	top?
pil	Verb	change
qelagu		young
atiu	Verb	do.thus
memen	Verb	1s.prs.dur?
noqa		
suu	Verb	serve.food,accompany
moen	Noun	tongue
kabut	Verb	hide,cover.up
aro	Noun	outside
gambor	Noun	basket
tutu	Verb	move
uja	Noun	digging.stick
pikus	Noun	rubber.tree
ati	Adjective	thus
a	Particle	emph?
laq	Verb	hear
gagai	Noun	uncle
les	Adjective	lazy
mulan	Verb	1d.rpst
bibriŋ	Adjective	other,various
Satan	ProperNoun	Satan.Eng
aqane		?
juu	Verb	stoke
iŋgros	Verb	scratch
b	Verb	1s.obj
balan	Verb	23d.?,23d.fut,23d.rpst
tater	Verb	take.out
bu	Noun	cane
nami	Adverb	long.time,early
ti		emph?
ge	Noun	spear
da	Verb	sing?,appear,arrive,become
aguy		short
bagri	Noun	hair,leaf
ibi		?
busen	Verb	3ns.prs.dur?
kabiw	Verb	show,teach
esen	Verb	ds.sim?,ss.seq?,ds.seq
Rasian	ProperNoun	Russian
Doum	ProperNoun	Doum
datu		what?
e	Particle	introduce.quote
mereu		dry.water?
laŋ	Noun	sky
fama	Noun	farmer.TP
tra	Noun	pl
Laloq	ProperNoun	Lalok.place
sambun	Verb	wait
kileŋ	Verb	saitim.TP=?
saŋal	Noun	crab
miŋga	Noun	rat
man	Verb	1s.rpst/fut,1s.rpst,1s.fut
bes	Verb	23ns.r.ss
sa	Verb	return.to?,go
utre	Noun	stump,way,kind,owner?,reason?
bu		?
buna	Noun	dove
yab	Adverb	yesterday
niuspepa	Noun	newspaper.TP
gute	Noun	depth
gagali	Pronoun	1de.emph
gumble	Noun	husband?
moqar	Noun	bean
kiap	Noun	colonial.official.TP
wes	Noun	urine
saŋgaŋ		watch.out.for
Jemeni	ProperNoun	Germany
uy	Verb	give.to.3p,give.to.3s
Tumbuqolom	ProperNoun	Tumbuqolom
sururuq		stand.on.top?
en	Verb	3s.rpst/fut/hab?,3s.rpst,3s.fut
qaŋ	Verb	pull,row.a.boat
na	Particle	and.TP
klia		clear.TP
am	Verb	2sg.ifut
beble	Noun	other.side
qanam	Noun	top?
i		?
qu	Verb	go
doru	Adjective	elongated
soqu	Verb	open
muru	Verb	bulge?
junum	Noun	name
tag	Verb	fetch
gor	Noun	joint
sabuqti		stupid?
jeram	Noun	wrist?
busun	Verb	3ns.pst.dur?
e	Interjection	hey,eh
n		3sg.poss?
qulgin	Verb	come.down
qal	Verb	shoot,break,pour,slaughter
injam	Pronoun	23p.poss
ain	Verb	3s.fpst
weipa	Verb	get.up
qaja	Noun	fight,police?
qanjurum	Noun	longmouth.fish
Magret	ProperNoun	Margaret.person
kone	Noun	neck
meqen	Verb	2s.prs.hab
jar	Verb	search.through
piti	Verb	kick.out
bauqu	Verb	hit
okam	Noun	hand.drum
oqu		
ŋuq		peel
u	Verb	put,throw
Galupi	ProperNoun	Galupi
wibi	Verb	?
d	Verb	bring
qoqolain	Noun	tree.sp
qabiŋ		
[...]		very?,emph
imbli	Noun	semen
sau		?
eu		?
ajijiyi	Pronoun	1s.emph
meren	Verb	12s.prs.iter?
Niugini	ProperNoun	New.Guinea
gurau	Noun	tree.sp
ñaro	Noun	trash?
qambu		unite
ŋaram	Noun,Verb	cover.up,bundle
qajir	Verb	pinch
yaw	Verb	burn
maqam	Noun	jaw
qun	Noun	bag
yau	Noun	take
ele	Noun	shoulder,carry
lambe		
qataŋ	Verb	bite
mosne	Noun	odor?
deŋgal	Noun	stick
taul	Noun	egg
aŋga	Noun	anchor.TP
oya	Verb	run.away
paŋ	Noun	piece
ombor	Noun	lid
laki		lucky
Jumbu	ProperNoun	Jumbu
ku	Verb	go
qabineu	ProperNoun	Kabineu
polis	Noun	police.TP
ambiliŋ		
Gulom	ProperNoun	Gulom
al	Verb	get.rid.of
aren	Particle	no
mari		carry
gaten	Verb	aim
kopra	Noun	kopra.bag.TP
tom	Verb	hold,try
g	Verb	give.to.1p
bun	Verb	3p.ss?,2ns.ds?
nau		now.TP
boro	Adjective	elder,big
qayer	Noun	blood
bo	Noun,Particle	or?,place?,epist.uncert
nal	Pronoun	3d
jir	Noun	cordyline
sagiu	Noun	armband
agul	Verb	fall
ndui	Pronoun	alone?
g	Verb	1ns.obj
on	Verb	see
dorwa		cold
qaŋgl	Verb	wander,stay
kot	Noun	court.TP
namidiŋ		
rau	Noun	wall
poloqt	Verb	leave.3s.obj
lola	Noun	prayer
besen	Verb	23ns.prs.hab,23ns.r.ds
sumbli	Adjective	small
Dagaum	ProperNoun	Dagaum
kas	Noun	tobacco
ambak	Verb	disobey
bilaw	Verb	swell
ilit	Verb	paint
laqa		below
qajoŋ	Noun	space
uleu	Noun	shore
ubutaun	Noun	roof.beam
boli	Noun	breadfruit
senaqal	Verb	boil
beu	Noun	brother.i.l
naŋglii		
mem	Verb	1s.prs,1s.ifut
boq	Verb	hungry?
aqar	Noun,Verb	hit?,whittle?,rest?
ubu	Noun	stone,height
Taulem	ProperNoun	Taulem
qamag	Noun	net/web
quriŋ	Noun	handle
je	Pronoun	who
qul	Noun	bowstring
gonim	Noun	magic
ŋam	Noun,Verb	eye,look.for
aba	Noun	sibling,sibling.i.l
kaŋgere		piece?
yesus	ProperNoun	Jesus
qabnau	Noun	marmot
kroŋgroŋ	Noun	frog
wulqot	Verb	dream
o	Interjection	oh
mem	Noun	father,master?
tenkyu	Particle	thank.you.TP
ñiñiji	Pronoun	2p.emph
boqole	Verb	try?
ajim	Pronoun	1s.poss
eu	Verb	hab.aux?,take
qeu		do.thus?
ŋalom	Noun	place?
yu		?
u	Verb	nmzr?
ndin		?
qu	Verb	fill?
bileŋ	Adjective	good
ugle	Noun	intestine
makim	Verb	mark.TP
sapos		if.TP
erea	Noun	area
abaj	Noun	sibling
saŋgeleŋ		dry
abun	Adverb	thus
memori	Noun	memorial.TP
ŋariŋ		hot
lili	Postposition	with
andunduyi	Pronoun	3s.emph
qobu	Noun	pond
igobu	Noun	pool
kapa	Noun	metal.TP
qoqobroq	Verb	break.redup?
trausel	Noun	turtle.TP
qei	Noun	what,thing
aji	Pronoun	1s
bitoq	Verb	jump
lala	Noun	tail.feather
pepa	Noun	paper.TP
e	Interjection,Particle	q?,eh,emph
Balama	ProperNoun	Balama
awu	Noun	rain
rum	Noun	room.TP
a	Noun	vagina
barata	Noun	brother.TP
wa	Interjection	yes
dubul	Verb	transform.into
oŋ	Verb	go
malain	Noun	ainang.TP?
koŋkoŋ	Noun	Chinese.taro
kon	Verb	swallow,cross
torom	Verb	help
plantesin	Noun	plantation.TP
mb	Verb	2s.obj,1pi.obj?
gi		?
bo	Verb	plant
tawel	Noun	towel
qulumna	Noun	paddle
unj	Verb	give.to.3p
bosim	Verb	control.TP
wau	Noun,Verb	garden,work,field
dul	Noun	vein
i	Noun	dat?
qalu	Noun	night,darkness
tinau	Noun	mainland
ole	Adjective	long
abrus	Noun	melon
oboq	Verb	open
magma	Noun	mother.in.law
berlan	Verb	23d.prs.iter
Qabuŋ	ProperNoun	Qabun.person
ŋil	Verb	vomit
laqat	Verb	avoid
diŋgi	Noun	dinghy.boat.TP
ga	Verb	be.missing
piksa	Noun	picture.TP
makau	Noun	cow.TP
yigum	Pronoun	1pi.poss
qaql	Verb	hit
gatuŋ	Verb	jump,cloze
mumbre	Noun	torch
tavre	Noun	chest
en	Verb	take.3s.rpst
um	Adverb	loc?
noi	Adverb	near
yawan	Noun	tree.sp
boqol	Verb	in.vain
awubi	Noun	cloud
moab	Noun	possum
qobul	Noun	widow
ayaŋ	Noun	yam
ga	Pronoun	1pe
ñij	Pronoun	2p
sain		?
dabagri	Noun	ear
moqolu		below
palim	Noun	k.o.pandanus
binda		
tumbuna	Noun	old.TP
banis	Noun	fence.TP
Gamaŋ	ProperNoun	Gamaŋ
geŋgunti		how.much
baqin	Verb	flow.fast
Don	ProperNoun	Don
gwal	Interjection	gwal
lalit	Verb	leave
s	Verb	?
siŋ	Noun	sun
ŋaŋai	Noun	aunt
sumbiŋ	Noun	flute
gom	Noun	path,reason
balaŋ	Noun	speech
bibraqt	Verb	tear,break.through
oho	Interjection	oho
teta	Noun	ladder
Saul	ProperNoun	Saul
neŋgreŋ	Noun	?,school
maŋau	Noun,Verb	custom,picture,thing
amblim	Noun	middle
berem	Noun	great.great.great.grandfather
pom	Noun,Verb	dip?,flood
qei	Pronoun	3s?
taŋgu		(magic.word)
dagaru		crooked
aŋamuru	Noun	underneath
qimbi qambariŋ		cranky
doqe	Noun	child.3s.poss
jelam	Noun	?,firefly
bagaleo		on.a.rack
sasawa		all?
bineu		later
tenemte	Adjective	?,correct
qul	Verb	go.down
dutla	Noun	skin
Gorendu	ProperNoun	Gorendu
gitaŋ	Noun	stone
ilog	Adverb	westward?,over.there
q	Postposition	obl,dat
sen	Verb	dur
qusawu	Adjective	wet
jigli	Noun	cucumber
brut	Verb	pierce
bail	Verb	be.strong
qutu	Verb	shake
Qururu	ProperNoun	Kururu
nambu	Noun	sister
tu		too.TP
mana	Noun	mountain
iboŋ	Noun	hand
tira	Verb	now?,go.ashore
aha	Interjection	aha
Gasom	ProperNoun	Gasom.person
ne	Particle	and
wi		hurt
name	Adverb	before,long.time,now?,first,in.front
yau	Verb	be.hot
gagayi	Pronoun	1pe.emph?
qali	Verb	know
epol	Noun	apple.TP
lata	Noun	ladder.TP
buga	Noun	spirit,white.person
Tok Pisin	ProperNoun	Tok Pisin
emen	Verb	1s.fpst,2s.fut?
mun	Verb	1ns.rpst/fut,1ns.rpst,1ns.fut
samba	Noun	leg
yu	Verb	?
misil	Verb	like
du	Noun	body
Tui	ProperNoun	Tui
resis		race.TP
keu	ProperNoun	Kawa
awal	Noun	breast
gau	Verb	avoid
buloŋna	Noun	gift
jon	Verb	become.wild?
gulumna	Noun	rudder
tu	Noun	chicken
qauwai	Verb	travel
aqal	Noun	bow
eria	Noun	area.TP
agam	Verb	cry
tf		disfluency
mei	Interjection	eee
dei		where
meit	Verb	sit.down.caus
kapsait	Verb	capsize.TP
padal	Verb	die
qabin	Noun	thing
kompensesen	Noun	compensation.TP
buge		some
Bang	ProperNoun	Bang.place
u	Verb	aux?
di		where
ana	Noun	food?
wiqna	Noun	story,spirit/ghost
dabu	Verb	shoo,clean.up,get.rid.of
taŋy	Verb	too.much?
aqai		topic?
ŋele	Verb	husk
abu	Noun	sibling.voc
doqal	Noun,Verb	cough,cough
se		empty?
mere	Verb	2s.imp.iter?
galum	Pronoun	1de.poss
oy	Verb	flee
w	Verb	make
yal	Pronoun	1di
Mundre	ProperNoun	Mindre
bar	Verb	hold,shake.hand
baku	Verb	carry
qaib	Noun	fish
qale		food?
yaiŋ		
buj	Verb	drill
qaqane		only?
qayaqun	Noun	tree.sp
olaw	Verb	lie.to
saw	Verb	go
tour	Verb	meet
awaya	Verb	buy.des?
moman	Noun	face
Bonem	ProperNoun	Bonem
stori	Noun	story
tatruye	Verb	throw?
palama	Noun	k.o.arrow
ñeu	Verb	scratch
qo	Verb	chop
qanaqum	Noun	tree.sp
aqen	Verb	take.3s.fut?
asen		?
garijog		set.samting.TP=?
qaglu	Verb	break
oru	Noun	tail
imel	Noun	email.TP
oj	Verb	?
muren	Verb	1ns.prs.iter?
jiw	Noun	k.o.pandanus
tamtar	Noun	others?
lam	Noun	lamp.TP
ar		
ber	Verb	23ns.prs
botuqt	Verb	cut
qadi	Particle	also
qasa		lie.giaman
gal	Pronoun	1de
pandiŋ	Verb	stand
qurrurru	ProperNoun	Kurrurru.place
utu	Noun	help
toum	Verb	hold?
bon	Noun	ironwood
war	Noun	k.o.pandanus
at	Noun	hat.TP
iti		follow
maklai	ProperNoun	Maklai
saqre	Adjective	tall
yobu	Adverb	quietly
taŋar	Noun	father.in.law
Garagasi	ProperNoun	Garagasi
sombrom	Noun	tail
po	Verb	split
nanjalum		3d.poss
