RED		nmlz
deni	ProperNoun	Danny
vupara	Verb	push
ñɨrama	Verb	hang.up
uzɨmɨŋa	Verb	fasten
takɨnam	Noun	weaving
ayagahu	Noun	tree.sp
samwel	ProperNoun	Samuel
arɨbi	Noun	k.o.yam
ahusa	Noun	betelnut
manat	Interjection	no
bak bak	Noun	wind.house
vidhug	Noun	eel
kwasa trɨ	Noun	water.frog
mar	Verb	2pl.imp
asɨŋas	Noun	bat
tɨmubu	Noun	fly
bubu	Noun	fan
mɨdapara	Verb	erect
maduri	Noun	bird.sp
mubu	Noun	k.o.skirt
ivam	Noun	journey
ñɨ		
aba		all.around?
hus	Noun	sore
hurV	Verb	fill
da	Verb	walk
ɨp	Verb	ctr
yam	Adverb,Adjective	still,new
mɨda	Verb	plant
pasiŋkap	ProperNoun	Pasinkap
akɨnɨk huza	Noun	breadfruit
ŋare		
ahur	Noun	tree.sp
hakayapa	Noun	butt
sɨs	Noun	grass
aŋravata	Verb	flee
vris	Noun	fish.sp
abahɨmu	Verb	perish
viŋa	Noun	platform
mɨŋañɨkɨr	Noun	k.o.pitpit
bazɨv	Noun	tree.sp
kwapa	Noun	side
ia	Interjection	here
ivɨda	Noun	cane
wɨya	Adverb	just
aŋañ	Noun	canoe(Aram)
ŋarva	Verb	break
mɨkug	Noun	cheek
yadama	Verb	mock
ipa	Verb	come.out
haña vad	Noun	tree.sp
mumu	Noun	thing
tɨhirama	Verb	pass
mudihra	Verb	peel
hrahra	Noun	shirt
guvu		
akuruda	Verb	carry.around
busak	Adverb	first
vatɨrama	Verb	spit
ŋañihra	Verb	tear
mapmadavi	ProperNoun	Mapmandavi
dohrat	ProperNoun	Dohrat
takura	Noun	throat,k.o.greens
ze		
askai	ProperNoun	Askai
amɨnak	Pronoun	2sg.poss
araisa	Adjective	yellow
ñɨvi	Noun	young.cross.niece
ayaga	Noun	sago
aria	Interjection	hey
rɨva	Verb	burn,sing
mura	Noun	k.o.greens
bat	Particle	let
mis ramwin	Noun	mushroom.sp
abaŋyapa	Noun	tree.sp
medeŋ	ProperNoun	Madang
mɨgrama		
upmira	Verb	thread
tsk	Interjection	tsk
in	Verb	1sg.ipst,1sg.prs,1sg,1sg.his,1sg.his
sɨ		
amuna		
varva	Verb	bear,birth
mun	Noun	edge
kapai		
gɨbitwar	Noun	bird.sp
humur	Noun	middle
adarɨñ	Adverb	dirty
kubruda		
cɨh	Verb	squeeze
apaga	Noun	chest
isɨha	Verb	serve
urahra	Verb	call.out
hañaba	Noun	hot.water
rɨk	Noun	area.below
birbir	ProperNoun	Bilbil
abiva	Verb	fight
brɨdɨm	Noun	beetle
mida		cousin
vɨkɨn	Noun	wife.3.poss,bird.sp
mɨñu	Noun	seed
ag	Particle	foc
hɨvɨrmɨdi	Noun	bird.sp
hisa	Verb	sew
urum	Noun	man
matarina	ProperNoun	Matarina
pɨ	Noun	house
ñɨ	Verb	stay
mɨkata	Noun	chin
ara	Verb	say
tak	Adverb	only
deñel	ProperNoun	Daniel
mɨkɨr	Noun	adam's apple, pipe,infant
ikɨva	Verb	cook
sava	Noun	hole
miok	Noun	other.people
gave		turn
nadi		daughter
tuki	Noun	rat
had	Noun	right
marakasa	Noun	bird.sp
aguvatɨkare	Verb	stand
pmira		
irɨbe	Verb	be.angry,shoot
sɨb		
ɨ	Interjection	uh
atas	Adverb	enough
misin	Noun	mission
avagara	Verb	yell
mai	Noun	point
vɨhɨr bripar	Noun	bamboo.sp
sɨmuñ	Noun	tree.sp
vinɨk		
winvara	Noun	vein
mat	Noun	what
vuvu anagara	Noun	tree.sp
varmehurmehur	Noun	bird.sp
sɨhun	Postposition	com
mɨr		
kai		
gurama		
haha	Noun	sugar
akirap	Noun	crab
guda	Noun	tree.sp
nad	Verb	2sg.ipst,2sg.prs,2sg,2sg,2sg.his
mad	Determiner	ben
mirɨb	Noun	tree.sp
rɨ	Verb	do
igra	Verb	put.in
mirvab	Noun	tongue
ñanak		son.2.poss
maipagaragara	Noun	bird.sp
azɨmap	Noun	sago.sp
hɨdabra	Noun	road
ipaku	Verb	go.across
don	ProperNoun	Don
mɨt	Noun	ds.sibling,bag
mɨŋatamañɨ	Verb	hear
hɨmñav	Noun	song
tas		
vɨgaña	Noun	pandanus.sp
nagid		be.near
muy	Noun	leftovers
madɨgɨm	ProperNoun	Madɨgɨm
waya	Noun	breadfruit
paka		
agɨrɨgu		
hakɨra	Noun	gap
akam	Noun	vagina
hɨtar	Noun	broom
ivan	Noun	lime
yara		everyone
soheram	ProperNoun	Sogeram
bɨñɨrɨ	Verb	be.ashamed
rai kos	ProperNoun	Rai Coast
kuv	Noun	ear
a		1.poss
apapara	Noun	grasshopper
mavhasa	Noun	wallaby
tabra	Noun	ridge
a	Interjection	ah
mɨgra	Verb	cut
arɨd	Pronoun	1pl.poss
iriña	Verb	lick
amɨhui	Noun	bug.sp
te	Verb	do.what
ikap	Noun	k.o.greens
va		father
ibira	Verb	organize
kñi	Noun	cough
mu	Verb	VERB
iriñc	Noun	k.o.greens
rɨku	Verb	see
mɨga	Verb	come.down
arum	Adjective	big
mɨs	Noun	sweetness
yɨ	Verb	carry
amɨzam	ProperNoun	Amzam
bra		
hiki	Noun	road,custom
ñarɨmbarɣu	ProperNoun	Nyarbarhu
ŋayaguru	Verb	disperse
gravɨha	Verb	fasten
mukunabi	Noun	k.o.basket
mad	Postposition	ben
hɨmra	Noun	mushroom,hat
ai	Interjection	ah
ñɨŋ		grandfather
ñɨŋa		
ni	Determiner	nd
tɨga	Noun	canoe
akamɨga	Verb	come.out
amɨgra	Verb	hit
amɨñ	Adverb	yesterday
rama	Verb	put
vu	Verb	go
rat	Verb	hab,hab.inf
kada	Verb	dance,talk.so
gɨr	Verb	1pl.far,1pl.rpst,1pl.mid
babad		
roda	ProperNoun	Rhoda
mavañagam	Noun	bird.sp
akɨrmɨga	Verb	bind
yaga		
memta		
rukuñe	Verb	look?
zamad	Pronoun	1sg.ben
vibi	Noun	mosquito.net
makɨr	Noun	snake.sp
aragra	Verb	approach?
mak	ProperNoun	Mark
had		
nadi	Noun	woman
apapa ragwi	Noun	mushroom.sp
vɨ		
brisva	Verb	comb
ipaka	Verb	come.across
kriva	Verb	look.for
sarasara	Noun	k.o.basket
avamdi	Noun	grass.sp
asɨgɨs	Noun	k.o.spear
avɨdi	Noun	bird.sp
akakara	Noun	tame.chicken
mɨzɨmɨz haha	Noun	k.o.sugar
akut	Noun	half,bottom
yabara	Noun	shin
migrama		
hucivra	Adjective	long
akebakɨd	Noun	eel
cukai	Noun	ringworm
hinahina	Adjective	crooked
vamkwa		
hɨm	Noun	weight
babrɨsɨŋ	Noun	bird.sp
kwadi	Noun	tree.sp
mɨra	Noun	air
ña	Verb	eat
taki	Noun	signal.drum
vasivasi	Noun	bug.sp
akahrɨs	Noun	tree.sp
añɨŋabi	ProperNoun	Añɨngabi
havya	Noun	bamboo.sp
kuruŋa		older.brother-i.l.
midaŋ		cousin.1.poss
kitiha	Verb	do.what
mip	Noun	plant.sp
ada	Noun	trash
azɨn	Noun	kunai.flower
kad	Postposition	ben
ipravu	Verb	finish
ŋarakɨba	Verb	open
vupre	Verb	cite
yarayara	Verb	everyone
kihaya	Noun	bird.sp
ma	Verb	pst
prama		
ida	Verb	wash.sago,set.up
ragu	Verb	clear?,step.on
ahɨti	Noun	thorny.yam
akɨrsi	Noun	waist
akɨrmɨgu	Verb	force.down
akavaŋku	ProperNoun	Akavanku
vɨhɨr	Noun	bamboo
ne		ss.e.sib.2.poss
adaŋadaŋa	Noun	k.o.basket
ivɨtɨ	Verb	pour
ivɨka	Verb	cut,write
yavara	Noun	bird.sp
huzam		nephew
yayabra	ProperNoun	Yayabra
bikman	Noun	bigman
mapma	Verb	split
ku	Interjection	woof
hit	Noun	chest
mɨrmɨr	Noun	white sap
iŋar	Noun	sun
hitɨr	Adjective	black
agugre		
apahir	Noun	fish.sp
huz	Noun	frame
apmu	Verb	carry
hup	Noun	place
mugwar	Noun	liver
agugru		
mɨŋarama	Verb	get.and.put
vivi	Noun	tree.sp
agɨmzɨ	Verb	lower
aŋarihɨn	ProperNoun	Aŋarihɨn
nagu	Noun	lizard
mahitɨr	Noun	snake.sp
hig	Adjective	black
prɨhara	Verb	flee
sɨrmɨd	Adverb	forbidden
vuhuhaka	Noun	snake.sp
tabɨñ	Noun	k.o.greens
utɨm	Noun	salt
pɨrmɨŋ	Noun	possum
tɨvra	Adjective	first
prigapɨŋap	Noun	snake.sp
tɨmabi	Noun	snake.sp
marɨk	Noun	sorcerer
yigra	Noun	game
saya	Noun	tree.sp
akripu	Verb	wrap
ibra	Verb	be.happy,mischief
kɨd	Postposition	char
abim	Noun	boundary
guña		
nagara	Noun	basket.type?
ragupa	Noun	tree.sp
sitaya	Noun	tree.sp
akubru	Verb	break
añɨga	Verb	dig
ayagɨtɨm	Noun	k.o.basket
batañɨ	Verb	sit.down
mivis	Noun	bird.sp
vɨha	Adjective	ripe
bunpa	Noun	ball
mavra mɨku	Noun	k.o.yam
madɨkɨma	Noun	fish.sp,k.o.pitpit
imɨr	Noun	meat
tasaŋ		brother.1.poss
zamak	Pronoun	1sg.emph
haya	Noun	jaw,shoulder
akune		
akɨru	Verb	carry
agrida	Verb	line.up
ɨtɨha	Verb	ffut
mutimuti	Noun	bug.sp
kwaik	Noun	possum
gɨv	Noun	anger
sɨbra	Noun	?
añɨŋa	Particle	two
vinvin	Noun	bird.sp
ŋamkwa	Verb	dawn,tear
vaca	Particle	one
m	Verb	2sg.imp
mukud	Adjective	other
wigra		
bogia	ProperNoun	Bogia
pra	Noun	canoe(Bakind)
ñiŋi	Adjective,Noun	child,little
mɨka	Adjective	male
ñanɨk		son.3.poss
mɨgada	Noun	bowstring
pɨhivra	Noun	bird.sp
rɨdɨm	Noun	root
avɨgur	Noun	bird.sp
avravɨr vɨgaña	Noun	pandanus.sp
avapma	Verb	chop,abound
bɨd		
atɨhu	Verb	wind.up
suari	Noun	bamboo.sp
d	Verb	?
twaya	Noun	white,bird.sp
tɨvɨgɨv	Noun	dusk
gavsɨŋ	Noun	bird.sp
vɨkre	Verb	open
yabrahad	Adjective	near
akuruvu	Verb	take.away
itu	Determiner	fd
akan	Particle	alright
vañihra	Verb	split
ŋatɨ	Verb	?
pubu		completely
mɨŋa	Verb	get
amɨŋuna	Noun	stomach
ra		ss.young.sib
hɨmu	Verb	die
kuñak	Noun	cockatoo.sp
i	Determiner	set
bɨt	Noun	bug.sp
aŋañahɨr	ProperNoun	Anganyahr
maŋamus	Noun	tree.sp
ruhuvad	Noun	rafter
pɨbɨr	Noun	shadow
amɨŋunak mɨŋa	Verb	grieve
hanɨb	Noun	tree.sp
ɨn	Verb	2sg.ds
namad	Pronoun	2sg.ben
visu twaya	Noun	bird.sp
kumɨt	Noun	ear.bag
agɨn	Noun	taro
o	Particle	q,int
yabob	ProperNoun	Yabob
mɨramɨñayapa	Noun	k.o.yam
hiyamkwa	Verb	eat? scoot?
ŋemta	Verb	drop
ivarm	Verb	break?
rɨt	Noun	dry.ground
ipra	Verb	break.up
ubram	Noun	arm
ɨr	Verb	2pl.ds
akɨkrɨs	Noun	snake
narmad	Pronoun	2pl.ben
havɨ		uncle
vat	Noun	center
sɨ	Noun	scale
bɨŋ	Interjection	juke
muvhu	Verb	wash.sago
asi	Noun	knowledge
gra	Verb	do
rɨvab	Noun	earthworm,bug
avimɨn	Noun	wild pandanus
bav	Noun	torch
akɨtɨhu	Verb	encircle?
gɨtɨmtɨm	Noun	bird.sp
agɨzɨra	Noun	crayfish
tukubrama		well
arada	Verb	make.noise
ñaŋña	Noun	food
tɨbi	Noun	hair
imɨrsi	Noun	afternoon
pabra	Noun	village
rahura		
pri	Noun	
vana	Noun	speech
gɨsɨ	Noun	armpit
hɨbragam	Noun	fish.sp
emtak	Adverb	alone
ñamaŋ		brother.1.poss
sudɨhaya	Verb	carry
hɨd		move
akɨmɨn	Noun	dream
hivɨda		
ar	Pronoun	1pl
hirɨr	Adjective	straight
kɨzahai	Noun	k.o.yam
madɨtɨm	Noun	snake.sp
upri	Noun	dog
pas		mother-i.l.
avihaya	Noun	k.o.pitpit
n	Determiner	acc
ahave	Verb	follow
ihuva	Noun	saliva,bird.sp
hudɨgɨr	Noun	tulip.string
tɨbra	Verb	?
nimida	Noun	cassowary
hra	Verb	roast,blow
kuru		
aginɨgu	Verb	finish
vaba	Noun	fence
kuvaha	Noun	ankle
tɨp haha	Noun	k.o.sugar
madamada	Noun	mango
ati	Noun	pl
ruhu	Noun	thigh
s	Verb	3sg.ds
ñɨ	Interjection	um
ñɨs	Noun	palm.sheath
ivasɨpu	Verb	hide
guvurama		
mɨna imɨn	Noun	tree.sp
mai	Adjective	sharp
paku		
maza	Noun	nose
nɨp	Determiner	people
avagai	Noun	tree.sp,sago.scraper
abarɨdum	ProperNoun	Ambarndum
kɨm	Noun	bird.sp
tat hivravhivra	Noun	k.o.greens
yaŋ	Noun	k.o.yam
hɨb	Noun	breast,knot
abɨ	Noun	presence
babazɨr	Noun	fish.sp
añɨranag	Adverb	day.after.tomorrow
iguvurama	Verb	give
sik		
zaŋa	Noun	rat
kɨtriku	Adverb	chopping
kukurama	Verb	think.about
ibirɨbɨh	Verb	messed.up?
avɨharme	Verb	drill?
vazi	Noun	tree.sp
bra	Noun	stick
irɨb	Noun	odor
ñas	Determiner	quantity
mav	Noun	loincloth
vaga	Noun	leaf
na		2.poss
takura hrɨs	Noun	k.o.yam
raprañɨ	Verb	wait.for
awa		
añɨr	Noun	sharpness
akuraku	Noun	bird.sp
irugu	Noun	tree.sp
muramura	Noun	bug.sp
zɨhid	Adverb	quickly
ivamku	Noun	vine.sp
sarapi	Noun	bug.sp
vra	Verb	buy
pɨtɨvra	Verb	squat
irkabi	Noun	fish.sp
ta		
kuhava		
akuku	Noun	pants
asɨha	Verb	take.out
sibevivi	ProperNoun	Simbevi
ka	Determiner	md.top?
hravɨha		
o	Particle	or
zabɨkur	Noun	hornbill
irhumɨna	Noun	lizard
mɨgramɨn	Noun	moon
pas		
vagara		
gra		
mɨdi		question?
agɨva	Verb	scratch
ahe	Interjection	ouch
win	Noun	tree.sp
i	Interjection	eek
ñavara	Noun	tree.sp
madaŋ		
adadat	Noun	snake.sp
amɨŋ	Noun	mother.1.poss
rum		
yipɨn	Noun	ashes
akai	Verb	arrive
avɨpure	Verb	miss
daram	Noun	Ramu
agramada	Verb	stand
vinak		cross.nephew
ivad		in-law
mɨŋatama	Verb	hear
kre	Interjection	ha
aŋam	Noun	law
rɨp	Particle	if
uratɨbra	Verb	jump
hida	Noun	side
mapmarɨ	Verb	split.open
ñɨŋuta		
atukur	Noun	bird.sp
mɨna	Noun	pig
agri	Noun	bee
ziŋed	Adverb	just.so?
abaŋ	Noun	fish.sp
igu	Noun	back.of.head
mɨdihra	Verb	break
hag	Noun	hook
kuña	Interjection	caw
amuh		brother.1.poss
kɨmɨn		
kune		
hibɨv	Noun	lung
mɨŋarɨku	Verb	touch
muhu		old.cross.nephew
haka	Noun	poop,palm
utɨg	Noun	canoe(Nend)
kad		
vre		
asvata	Verb	lick
ɨn[...]ɨn	Verb	2sg.ds~sim
vɨsa	Noun	skin
tɨbɨhara	Verb	turn,reference
igu	Verb	give
ŋada	Noun	day
prɨha	Verb	flee
avayamu	Noun	turtle,k.o.pitpit
aŋra	Verb	run
avihai	Noun	tree.sp
avat	Noun	swamp
pagara	Verb	roll
hrarse	Verb	dry
mɨŋahare	Verb	follow.along
huza	Noun	k.o.yam
nɨm	Noun	k.o.arrow,tree.sp
muzi	Noun	bird.sp
ba	Determiner	loc
warɨm	Noun	bird.sp
b	ProperNoun,Determiner	nom,nom,nom
ihid	Noun	second
menagu	Noun	lizard.sp
ke	Verb	do.thus
adam	Noun	leg
hati	Noun	guys
mɨdubru	Verb	beat
ŋwamkwa		
imu	Verb	cook
madɨvɨhu	Noun	bird.sp
ire	Postposition	like
sɨha		
vɨta	Adjective	wet,old
s	Verb	3sg.imp
yak	Pronoun	1sg.poss
atebre	ProperNoun	Atemple
irɨv	Noun	bird.sp
his	Adverb	before
ñadika	Noun	fish.sp
vrɨt	Noun	k.o.pitpit
cɨwari	Noun	bird.sp
i		brother
hapsɨhi huza	Noun	sweet.potato
hakɨrum	Noun	snake.sp
bar	Noun	canoe(Chini)
bra		
rɨsrɨs	Noun	lizard.sp
ŋarida	Verb	open
adavi	Noun	name
benke		how
uda	Verb	work?
hasɨbi	Noun	bird.sp
nɨm	Adjective	big
hɨpa	Adverb	very
urabu kɨnavɨhur	Noun	k.o.edible.shoot
rɨm	Noun	noise
hɨdah	Noun	Ramu.people
dɨ	Noun	barricade
mɨgaña	Adjective	female
senis		change
hupi	Noun	main.joint
asi	Noun	decoration
auka	ProperNoun	Auka
hid	Noun	after
n	Verb	2/3.ss
ñagida	Noun	betelnut.sp
ayapara	Verb	come.over
ŋam	Adverb	holding
m		mother
devit	ProperNoun	David
sa	Interjection	hey
rɨŋa	Noun	sloth
akyabakɨd	Noun	k.o.pitpit
mɨzubu	Noun	betelnut.sp
o	Interjection	oh
sɨhat		grandmother
mɨgu	Verb	go.down
ed	Particle	inferential
ŋara	Verb	speak
abur	Noun	tooth
hɨda	Noun	stick
ataraba	Noun	tree.sp
ihad	Adverb	now
gipu		peer
ini		
isib	Noun	size
ratɨhada	Verb	disperse
uras[...]uras	Verb	pl-3.ds~sim
hɨvɨrkɨvɨr	Noun	tree.sp
nɨmad	Pronoun	3sg.ben
bɨsɨŋ	Noun	mosquito
inam	Noun	fat
yagutɨm	Noun	sago.basket
give	Verb	mark
azagur	Noun	flowers
bɨ	Pronoun	3.nom
agayam	Noun	snake.sp,k.o.arrow
vaŋa	Noun	side
ni		
tɨguvri	Noun	bird.sp
tɨptɨp	Noun	dust
urarama	Verb	raise
iramɨŋa	Verb	burn.off
akɨba	Verb	appear
añɨrumɨdu	Verb	laugh
akumɨgu	Verb	go.across
atɨva	Verb	pull.out
isɨb	Noun	top
apɨhu	Verb	go.downstream
bak	Determiner,Noun	poss,poss
ŋahɨr	Noun	fish.sp
iva	Verb	hit
ñazu	Noun	pandanus.sp
tɨhi		exceed
vɨha		
tat	Noun	fire
grɨ		
ura	Verb	pl
tumi	Noun	bug.sp
ŋuria	Noun	fish.sp
ita	Verb	leave
ibum	Adjective	real
sailes	ProperNoun	Silas
ava	Noun	pl
nanim	ProperNoun	Nanim
maka	Noun	branch,loop
raŋ	Verb	1pl.imp
daŋadaŋa		
vɨh	Verb	yell?
maŋa	Noun	ground
ŋirɨpma	Verb	fear
va		
r	Verb	1pl.ds
akubruda	Verb	break.apart
akai	Adverb	comp
irɨp	Noun	bow,limbum
ñɨŋi		
vapara	Verb	walk.around
avɨhase	Verb	hollow.out
ñɨŋi	Adjective	all
kɨvara	Verb	cook
urir haha	Noun	k.o.sugar
añɨru	Verb	laugh
isɨ	Verb	fill.container,set.out
rabra	Verb	abound
gɨm		
banɨk	Determiner	poss
irɨkɨm	Noun	fish.sp
ararirɨ	Verb	weave
ahasapa	Noun	gorgor
ñɨvñɨv haha	Noun	k.o.sugar
ŋaribra	Verb	break
avravɨr	Noun	small.yellow
ŋɨn	Verb	1sg.far,1sg.rpst,1sg.mid
mɨditɨ	Verb	ask
ikuru	Verb	fuck
mɨdupara	Verb	push
urir	Noun	parrot.sp
iri		lick
mɨŋamzɨ	Verb	pull
agamɨgu	Verb	encircle
hiva	Noun	anklet,footprint
ai	Verb	come
dabr	Verb	fall
agamakaka	Noun	k.o.yam
avaŋ	Noun	father.1.poss
mɨka	Noun	tusk
hɨpa	Noun	stick
ivayag	Noun	k.o.yam
hipa	Noun	steal
aminahu	ProperNoun	Aminahu
mɨŋañikɨr	Noun	wildfowl
mɨnanɨk ayaga	Noun	axe.handle
sɨbu	Noun	k.o.greens
yapurhɨma	Noun	bug.sp
mavra	Noun	crocodile
bara	Noun	stick
ayaga hɨmra	Noun	mushroom.sp
taŋapa	Noun	bird.sp
arumadarum	Adjective	enormous
mu		brother
yapa	Noun	source
mapañ	Noun	bamboo.sp
has	Noun	sand
aregu	Verb	straddle
avan	Adverb	very
upas	Noun	banana
barɨ	Verb	carry
nar	Pronoun	2pl.acc
manɨp	Noun	spirit.man
murmur	Noun	tree.sp
hri	Noun	bone
adar	Noun	spirit
vab	Noun	wing
tagira	Verb	turn
kot		court
ŋar		
mam		husband
kɨtɨmɨn	Noun	tail
zɨha	Verb	care.for
aramaram	Noun	tree.sp
mɨzɨmɨz	Noun	crayfish
hivra	Adjective	long
map	Noun	head
nogat	Interjection	nogat
amemta	Verb	scoot
harama	Noun	side
marha	Verb	cock
kai	Postposition	loc
tegeveve	ProperNoun	Tengeveve
katas		
agruva	Verb	break (intr)
hɨmrahɨmra	Noun	mushrooms
varami	Noun	gecko
akad	Adverb	maybe
ape	Verb	close,thatch
agrama	Verb	stand
asi	Noun	sneeze
krɨbagati	Noun	tree.sp
kɨva		
ana		?
hɨrmava	Noun	earthquake
ñagavɨr	Noun	teenage.boy
añɨŋi	Noun	boy
ŋakapara	Verb	push.away
muhrɨt	Pronoun	some
ivarida	Verb	clear.across
aragru	Verb	approach?
am	Pronoun	2.nom
yɨmɨn	Noun	tree.sp,k.o.basket,cloth
bɨr		?
rɨd	Noun	back.of.joint
vɨhɨr ibum	Noun	bamboo.sp
rɨb	Noun	piece
apa	Noun	edge
amgapa	Noun	cheekbone
iragɨt	Noun	k.o.banana
kɨciŋ	Adjective	small
eʔe	Interjection	okay
sibevi	ProperNoun	Simbevi
ain	Noun	k.o.spear
hanagu	Noun	rafter
ragam		exist
nad	Pronoun	1du
taku	Noun	bird.sp
havagava	Noun	bird.sp
banɨk	Pronoun	3sg.poss
pɨntɨm	Noun	fish.sp
rha	Verb	hab
asɨhara	Verb	take.out
yɨhu	Verb	disappear?
pɨhɨn		wife
nɨgibum	Determiner	adjz.very
saraka	Noun	flyswatter
ñɨtraka		
pever	ProperNoun	Pever
amidamid	Noun	bug.sp
ñɨ	Pronoun	who
kɨdi	Noun	box
hap	Noun	axe
vara	Verb	sweep
bɨrmɨgañɨŋa	Verb	hang.out
vakai	Noun	left.arm
kwimahab	Noun	snake.sp
ramaku	Verb	put.up
z	Verb	1.ss
nɨ		3.poss
pra	Verb	bathe
duŋ	Interjection	boom
ŋab		
añɨ	Noun	eye
hɨmri	Noun	cold
huma	Noun	coconut
rarhumag	Noun	k.o.pitpit
ey	Interjection	hey
ragumar	Noun	tree.sp
sɨvar	Noun	tree.sp
pan	Noun	strap
amus	Noun	blood
akun	Verb	get?
hare	Verb	?
ibra	Noun	work
sudɨ	Noun	dance
katar	Noun	jawbone
var	Particle	indeed
bateri	Noun	battery
nɨd	Pronoun	2/3du
añɨrumɨ	Verb	laugh
ee	Interjection	uh
añɨhriñ	Adverb	day.before.yesterday
avagab	Noun	tail
abu	Noun	size
akuña	Verb	net.fish
yavrara	Noun	tree.sp
mai	Noun	bean
mɨgrat	Noun	tree.sp
hubu	Noun	nail,fish.sp
agam	Noun	fight
mirmir	Noun	k.o.pitpit
anaku	Verb	talk
ñivi		
hɨmahɨma	Noun	tree.sp
zihuma	Noun	k.o.yam
zagrara	Noun	bird.sp
tɨbɨha		
rukuñɨ	Verb	watch.over
akunai	Verb	bring
na	Interjection	and
muduñɨ	Verb	stay.put
ñɨŋañɨ		
ñarmadavi	ProperNoun	Ñarmandavi
anagara	Noun	limbum
varagra	Verb	sweep,carry
nabu		
aka	Verb	come.up
urahura	Verb	call.out
zenɨgɨm	Adjective	like.1sg
amerika	ProperNoun	America
imɨru	Verb	wake.up
mɨdimɨdi	Adverb	slowly
kñikñi	Noun	tree.sp
uzam		
kudikudi	Noun	frog.sp
nakad		be.mid
irha	Verb	cry
irugu hɨmra	Noun	mushroom.sp
bata	Verb	sit
jona	ProperNoun	Jonah
kimahab	Noun	snake.sp
hamura	Noun	mustard
hav		
kuku		think
aihu	Verb	vomit,work
tɨkria	Noun	k.o.yam
irɨpagin	ProperNoun	Irpagin
arumad	Adjective	big.pred
añɨri	Adverb	day.after.tomorrow
adɨ	Verb	process.sago
kwasa	Noun	frog
agramañɨ	Verb	stand.up
ɨmɨr	Verb	2pl.proh
sukai	Noun	tobacco
asik	Adverb	again
barvɨra		
d		char
sagra		hug
mɨgañɨ	Verb	sleep
hɨbɨma	Noun	hand.drum
pasɨm	Adjective	younger
mɨru		
huzam		aunt
ñɨtaka	Verb	get.up
gaku	Verb	raise
trama		
añɨŋata	Verb	take.off
akutava	Noun	leaf.type
vugugu	Noun	wall?
tɨp	Noun	post
ipmu	Verb	hoe
bavad	Adverb	quickly
avɨha	Verb	chop,unite,tie
ñaŋ	Noun	husk
yawrasa	Noun	k.o.yam
amarad	Pronoun	2pl.poss
mad	Noun	back
kwaik humɨn	Noun	k.o.pitpit
agɨmze		
akatas	Adjective	finished
ɨt	Verb	1sg.ds
ka	Determiner	md
kubru		
id	Verb	3sg.ipst,3sg.prs,3,3sg,3sg.his,3sg.his
añɨŋuta	Particle	three
ukra	Verb	grow
kurumɨn	Noun	white.hair
ñɨr		
gipaku	Verb	go.across
agu		?
tɨpi	Noun	hips
vɨgaña amus	Noun	pandanus.sp
waid	Adverb	before
rɨvad	Noun	heat
ize		able?
aresa		
mayamɨŋam	Noun	bird.sp
him	Noun	grass.sp
aprañanag	Adverb	two.days.after.today
apara	Verb	throw,line.up
agin		totally
ɨtɨŋ	Verb	1sg.imp
ku	Noun	knot
añɨra	Verb	sharpen
marhu	Verb	cock
mira	Noun	light
amid	Noun	axe,scorpion
mai	Interjection	hey
metyu	ProperNoun	Matthew
rapra	Verb	wait.for
magara	Noun	grass.sp
nɨgɨm		adjz
irañaguva	Noun	k.o.yam
mayab	Noun	bird.sp
oi	Interjection	hey
sɨrɨbi	Noun	armor
igi	Noun	palm.bark
mɨdu	Verb	shoot
g	Verb	3sg.far,3sg.rpst,3sg.mid
habɨhab	Noun	tree.sp
as	Particle	so
gɨmag	Noun	neck
mag	Noun	louse,calf,eye
hud	Noun	vine
ipakut	Noun	backside
ŋatɨtrɨ	Verb	pull
sɨmkɨr	ProperNoun	Sɨmkɨr
dakuru	Verb	walk.around
viru	Noun	bulb
hari	Adjective	strong
hur		
azɨnhaka	Noun	snake.sp
igɨm	Noun	fog
ni	Noun	ss.e.sib.3.poss
haña	Noun	soup
vasi	Noun	plate
akatrama	Verb	be.very.full
husi	Noun	section
mɨŋahara	Noun	fish.sp
dɨv	Noun	meat
añɨŋu	Noun	ancestor,man
apɨha	Verb	come.downstream
hibre	Verb	ready
abrus	Adverb	tomorrow
ɨtraka	Verb	ifut,fut.inf
mapme	Verb	break
ña	Noun	son
pare	Noun	fall
varɨmkrimkri	Noun	bird.sp
humabra	Noun	clearing
humuta	Noun	k.o.yam
zɨ	Pronoun	1sg
avamkwa	Verb	cut
ŋagara	Verb	shake
mɨnɨkɨm	Noun	sago.grub
kuhɨn	ProperNoun	Kuhɨn
ma	Particle	neg
abɨhrɨs	Noun	tree.sp
ihravɨha	Verb	tie
barad	Determiner	poss.pl
iguña	Verb	feed
para	Verb	force?
uradɨgin	ProperNoun	Uradɨgɨn
vɨ	Noun	night
givɨha	Verb	translate
hɨya	Verb	bite
ñavi	ProperNoun	Nyavi
kɨna		ds.sibling
trɨ	Verb	pull
bram		
akapai	Adverb	wrong
muku	Noun	egg
pakut		
irɨzabi	Noun	k.o.pitpit
nadigam	Noun	daughter
nɨ		
yaz	Noun	greens
r	Verb	1pl.ipst,1pl.prs,1pl,1pl,1pl.his
vata	Verb	swim,boil
agugra	Verb	take.out
pravurama	Verb	hide
añɨp	Noun	navel
akɨmaz	Noun	stone
sɨprɨhu	Noun	tree.sp
mam	Noun	grass.skirt
kwarɨk	Noun	bandicoot
midak		older.brother-i.l.
mavat	Noun	k.o.yam
cɨp	Particle	able
pɨhai	Noun	k.o.greens
tɨka	Adjective	strong
barad	Pronoun	3pl.poss
s[...]s	Verb	3sg.ds~sim
vuga	Noun	big.netbag
ŋamañ	Noun	fish
apɨhuta	Verb	show
ipamɨga	Verb	arrive
ura	Verb	call.out
agɨnɨb	Noun	nape
in[...]in	Verb	1sg.ds~sim
mukmuk	Adjective	various
aibɨzɨŋ	Noun	bandicoot.sp
mavayapa	Noun	k.o.yam
ratɨha	Verb	disperse
ŋañahɨr		
uras	ProperNoun	Uras
ɨmɨn	Verb	2sg.proh
sayasaya	Noun	tree.sp
ihɨr	Noun	child
akɨvsisi	Adjective	one.side
rad	Verb	2pl.ipst,2pl.prs,2pl,2pl,2pl.his
yapɨr	Noun	debris
pravu	Verb	hide
iran	Noun	parrot.sp
mirinvu	Verb	swallow
hivhi	Noun	lizard.sp
apahibre	Verb	nervous?
amgumi	Noun	inside
ŋavazɨre		
mɨnanɨk	Noun	spear
bamak	Adverb	only
hamña	Noun	poisonous.leaf
bɨñ	Adjective	inconsistent
zi	Noun	yam
vɨka		
ñɨhɨmɨn	Noun	tree.sp
gakurɨku	Verb	look.up
avai	Noun	k.o.arrow
krikri	Noun	mushroom.sp
vɨhɨr gwi	Noun	bamboo.sp
krɨs	Adjective	bad
spiku	Noun	rope
akɨnɨk	Noun	k.o.greens
mabar	Noun	bug.sp
akɨvahasa	Noun	snake.sp
amɨn vɨhɨr	Noun	red.bamboo
at		
yamat	Adverb	now
nadɨmɨŋai	Noun	frog.sp
iŋab	Noun	thunder
k	Determiner	acc
mɨkuvɨsa	Noun	mouth
pañamar	ProperNoun	Paynamar
humɨn	Noun	k.o.sugar
ɨtra	Verb	purp
mahyamkwamkwa	Noun	bug.sp
rɨs	Postposition	com
ba	Determiner	qd
ŋuŋu	Noun	wildfowl
hivi	Noun	piece
ɨnadurid	Verb	3pl.proh
barakam	ProperNoun	Barakam
gakurama	Verb	put.on.top
ŋarai	Verb	follow
bira		
agati	Noun	fish.sp
ramaka	Verb	put.together
yaba	Noun	water
iguvu	Verb	proceed
rudi	Particle	pl
mu	Adjective	spec
tɨgupi	Noun	lizard.sp
madan	Verb	?
barɨgar	Noun	small bag
ipu	Verb	go.in
mɨra	Verb	lower
ŋavezɨre	Verb	sag
aza	Noun	hole
nɨmɨdav	ProperNoun	Nmndav
var	Noun	garden
hɨs	Noun	smoke
pɨgɨm	Noun	bird.sp
ñɨŋar	Determiner	temporal
mɨkɨñ	Noun	fishing.net
akei	Interjection	okay
ibɨd	Adjective	good
vas		husband's.e.bro
bamda	Noun	morning
virbir	Noun	star,year
kuraku		
nakai		be
dokas	ProperNoun	Dorcas
siva	Verb	mow
har	Adjective	unripe
mugar	Noun	middle.of.palm
abarvɨra	Verb	change
buŋim		put.together
sud	Noun	spirit
ŋɨnad	Verb	2sg.far,2sg.rpst,2sg.mid
ruben	ProperNoun	Reuben
a	Verb	say?
mɨkatar	Noun	slander
akɨn		
muna	Noun	back
suaru	ProperNoun	Suaru
makat		none
adɨhɨt	Noun	skin
pu	Interjection	bang
vɨni	ProperNoun	Vɨni
midak		
zɨrmɨn	Noun	flower
mɨkɨm	Noun	shoot
guru	Verb	count
nimdabarɨgar	Noun	cocoa
tɨm		
pɨñ	Noun	desire
visu	Noun	bird.sp
mɨrsi		
zivirpir	Noun	bird.sp
aprama	Verb	cover.up
hip	Adjective	unripe
mut	Noun	week
rɨbu	Verb	tie
amen	Interjection	amen
a	Particle	int
gɨbirbir	Noun	tree.sp
nadai	Noun	teenage.girl
ura	Noun	forest
kanke	Verb	do.that
mɨga		
adamkubrubru	Noun	bug.sp
hiya	Verb	bite
zed		
azɨ	Noun	decoration
grad	Verb	2pl.far,2pl.rpst,2pl.mid
vad		wife's.y.brother
tɨk	Interjection	click
upɨ	Verb	wash (tr)
nɨ	Pronoun	2sg.acc
mɨkɨñɨz	Noun	cane
pɨn	Noun	group
hɨtɨr	Noun	thought
hamña amus	Noun	tree.sp
hutmag	Noun	heart, pulse
nabu		sister-i.l.
mɨrɨnavɨdi	Noun	turtle
i	Particle	q
kŋed	Adverb	thus?
abai	Noun	forehead
nagutid		be.far
ɨnad	Verb	3sg.proh
ŋamira	Noun	lightning
mɨhra	Verb	take.much
igurama	Verb	fill,help
si	Interjection	shoo
ŋaraih	Verb	tell.story
gwanɨb	Noun	bird
se	Verb	dry
atrama	Verb	stand.up,be.full
uradakri	Noun	betelnut.sp
amɨgrama	Verb	arrange
hupahupa	Noun	tree.knot
aku	Verb	go.up,wear
gap	Noun	bite
inɨ	Determiner	nd
avɨr	Noun	air,rope
vrai	Verb	embrace
ñagɨñag	Noun	wash
mayaku	Noun	tree.sp
vad	Noun	tree
varatɨva	Verb	pull.out
mɨdapma	Verb	open
huga	Noun	k.o.basket
abra	Noun	place
ŋudaka	Verb	take.off
vuhur	Noun	tree.sp
rɨba	Noun	shore
prɨmɨguñ	ProperNoun	Prmguyn
yum	Noun	fish.sp
ramnad igwi	Noun	mushroom.sp
nagunagu	Noun	tree.sp
nɨrmad	Pronoun	3pl.ben
ragati	Noun	tree.sp
pra		
hava	Noun	group
tɨm	Noun	sprout
añɨŋa	Verb	hang
apar	Noun	mountain
aguruva	Verb	break
ŋamka		
mɨgɨn	Noun	penis
aramad	Pronoun	1pl.ben
vayag		grandfather
uhɨr	Noun	shadow,spirit
ŋwamka		
kɨba		
amɨga	Noun	eye
tumunai	Adverb	before
ŋumiŋina	Noun	coconut.sp
tɨkra	Noun	bat.sp
pu	Noun	interior
