qoro	Verb	shoot?
woqli	Noun	activity?
ar	Noun	tree.sp
daqni		
ai	Adjective	old
saga	Noun	greens
elbi	Verb	3sg.fpst
mam		hungry
roŋ		wrong
bubuŋ	Adverb	there?
gamba	Noun	shell,plate
te	Verb	do?,caus
de	Verb	appear,be.high
Papayom	ProperNoun	Papayom
slaŋ	Noun	stick
keŋdandir	Noun	kookaburra
sabrud	Noun	butterfly
nde	Particle	dem
tumbrum	Noun	fog
poket	Noun	pocket
yagai	Noun	lagoon
kubuqo	Verb	swell
andoga	Pronoun	3pl.agt
jigli	Noun	cucumber
kem	Verb	2sg/1.hod.ss
kaqam	Noun	moon
ibom	Noun	fence
Rasik	ProperNoun	Rasik
ulo		hide
gabman	Noun	government
mun	Verb	1pl.rem.ss
damuy	Noun	ear
bjle	Adjective	soft?
matu	Adjective	firstborn?
masalai	Noun	spirit
Qalom	ProperNoun	Qalom
kuyo	Particle	maybe
peser	Adverb	quickly
ken	Verb	3sg.hod
nambul	Particle	pl
aqedu		finished?
sit	Noun	seat
makim		mark
taqal	Verb	hit
wal	Noun	breast
Maklei	ProperNoun	Maclay
leta	Adverb	here
nmbr	Verb	see.2sg.obj
yesem	Adverb	d.a.tomorrow
aita	Verb	?
Awoŋ	ProperNoun	Awong
jub	Noun	hole
bom	Noun	fence
oboq		open
imbar	Noun	bamboo,pipe
atwok	Noun	hard.work
rawaŋ	Noun	parent.i.l
koq	Verb	3sg.ss
ŋam	Noun	tree
bjroq	Verb	remove?,come.loose
punjuq		kiss
qureb		all
subyi	Verb	be.?
ŋam taŋgi	Noun	clan
aro	Pronoun	3sg
mlal		good
dan		sit.sg
moko	Noun	cover
saŋgati	Noun	rafter
Sausi	ProperNoun	Sausi
gobe	Noun	k.o.food?
marsin	Noun	medecine
gago	Pronoun	1pl.poss
qa		loc,ins
barum	Noun	signal.drum
uriq		hit?
si	Noun	bracelet?
ura	Adjective	dry
taqlgi	Noun	rib
mui	Noun	hair,leaf
quwiŋ		swim
woi		run
qen	Noun	mosquito
dab	Noun	ear
aklok	Adjective	o'clock
qoqo	Verb	look.pl
aq	Verb	1sg.ctrf?
yi	Interjection	oh
tabu	Noun	gun
mumu	Noun	stone.oven
wanawa	Adverb	one.hour
distrik	Noun	district
mb	Verb	2sg.obj
mm	Interjection	huh
Sigma	ProperNoun	Sigma
Mai	ProperNoun	Mai
smug	Noun	web
qo		look
pala	Adverb	today
pin	Noun	food,thing
ŋai	Noun	aunt
ŋwaŋ	Noun	brush.turkey
e	Particle	q
yaulqo	Adjective	yellow
asi	Verb	3sg.fut
yuwal	Noun	sea
tos	Noun	flashlight
sautim	Verb	buy.for
pulu		return
boge		trick
kri	Particle	compl?,be.quiet?
pipin	Noun	things
sol	Verb	carry
kona	Noun	corner
baqlu	Noun	platform
kuben	Noun	fishing.net
Jilim	ProperNoun	Jilim
absi	Verb	eat.2pl/3pl.fut
sol	Noun	salt
belo	Noun	noon
maski	Interjection	nevermind
be	Verb	2pl/3pl.ipfv
bsnem	Noun	part
sekim		check
Mlelqa	ProperNoun	Mlelqa
tam	Interjection	wait
g	Verb	1pl.obj
kwen	Noun	left.hand
kuqli		murky
añaqli	Noun	mother
alibi	Adverb	d.b.yesterday
kreq	Verb	scrape
ailan	Noun	island
bruk		disperse
sambi	Noun	yam
saŋ	Noun	dog,police
wen	Verb	see
onim		turn.on
tumbu	Noun	mountain
qabu	Adjective	true
user	Verb	show
lit	Verb	travel
mali	Adjective	ripe
kel	Verb,Noun	what,do.what?
Jam	ProperNoun	Jam
Ileg	ProperNoun	Ileg
mondoŋ	Adverb	later
pat	Verb	land
kraro	Noun	tree.sp
Nelson	ProperNoun	Nelson
mnmen	Noun	earthquake
jaq	Verb	take.pl
yasa	Noun	cane
dqnei	Noun	branch
qoŋgol	Verb	remove?
uqa	Verb	desid?
sslo	Noun	worry
totor		join
walaqli	Adjective	long
gredwan	Noun	first.grade
let		
subat	Verb	bury
kum	Verb	chop
ulig		sharp
une	Noun	problem
moin	Noun	tongue
yuri	Adverb	Sunday
ayiq	Verb	not.want
meme	Noun	goat
kampani	Noun	company
ubsi	Verb	2pl/3pl.fut
boi	Noun	boy
lagab	Noun	raincloud
sŋgreŋ	Noun	twig
yoŋen	Noun	footprint
qlai	Adjective	big
gal	Particle	neg
temen		
tf	Interjection	speech.error
gama	Pronoun	1pl.agt
dal		wrap
qneŋ	Adverb,Adjective	small,slightly
Mak	ProperNoun	Mark
seben	Noun	skirt
qumbla		
Kimbe	ProperNoun	Kimbe
niŋ	Pronoun	2sg.poss?
atiŋ	Adverb	maybe
tarum	Noun	source?
gusa tal	Noun	morgue
paul		mess.up
ati	Verb	put.in?
[...]		dur?
a	Verb	?
qawi	Noun	lime
igen	Verb	3sg>3sg?
jagi	Particle,Adjective	emph,different
qamun	Verb	come.1pl.rem.ss
Sisi	ProperNoun	Sisi
gteŋ	Noun	rat
belaq	Noun	fire,roast
doqomnak	Noun	nape
tar		top
um	Verb	2sg/3sg.ctrf?
dabu	Noun	edge
hahaha	Interjection	haha
Qaulibi	ProperNoun	Qaulibi
simbaŋ	Noun	taro.sp
ubye	Verb	?
qurat	Verb	compl
naintineiti	Noun	1980
qoqole		four
be	Particle	spec
gureŋ	Noun	flower
kriŋ	Noun	frog
oq		?
ñoblo	Noun	blessing
Kaliwa	ProperNoun	Kaliwa
krit	Verb	compl
Gamar	ProperNoun	Gamar
hã	Interjection	oof
stop		stop
pagli	Noun	parents
man	Noun	nose
gout	Noun	goat
qolo		be.dark?
poi	Verb	break
bjruq		
abrus	Noun	melon
jenjeŋ		embrace
daŋgal	Noun	stick
yagl	Verb	bathe
kukulbe	Noun	behavior
keŋ	Noun	sun
luluwai	Noun	luluai
damug	Noun	meat
draiva	Noun	driver
poloq		leave
Goroka	ProperNoun	Goroka
o	Interjection	oh
gl	Verb	go
ami	Noun	smoke
qau	Noun	betelnut
gigir	Verb	bury
yaqa	Pronoun	1du
Malfun	ProperNoun	Malfun
bsqaq		slip
baŋ		fall
koŋiri	Noun	neckbone
piksa	Noun	picture
qobob	Noun	mud
wai	Verb	look.for
suga	Noun	sugar
qaboq	Adjective	full
Kunum	ProperNoun	Kunum
paip	Noun	pipe
kekle	Noun	basket
tutu		above
ñqr	Verb	sharpen
sasa	Noun	ghostliness
wunqo		dream
faifaklok	Adverb	five.oclock
lodim	Verb	load
qaqai	Adverb	slow
qame	Verb	come.2sg.ipfv
nosqo	Pronoun	2du.poss
ye	Verb	3sg.rem.ss
gunguni		how.many
tut	Verb	bump?
kibi	Verb	2pl/3.ypst
eria	Noun	area
wag	Verb	put.in,wear
alam	Noun	yam.sp
doŋom	Noun	name
klen		select
grup	Noun	group
tri	Adjective	three
maŋ	Noun	uncut.garden
sirin	Noun	cane.sp
wi	Noun	ashes
raqum	Noun	car,crab
bed	Noun	axe
tutur		not.know
aria	Interjection	okay
boqol	Verb	dig
oŋŋ	Interjection	uh
qusmol	Noun	k.o.greens
gurebqo		all
qo	Verb	?
skul	Noun	school
ŋiri	Noun	bone
Siaŋ	Noun	Siang
gusiq	Verb	fart
kubag	Noun	leg
Goi	ProperNoun	Goi
boskru	Noun	crew.chief
Metyu	ProperNoun	Matthew
Kelsi	ProperNoun	Kelsey
[...]	Verb	dur?
nŋgr	Verb	see.2pl.obj
qamen	Verb,Noun	question,ask
wereŋ	Noun	pandanus
dur	Noun	large.plate?
igum		
keŋkeŋ	Noun	parrot.sp
jjgel		tease
Yagou	ProperNoun	Yagou
ui	Interjection	oof
bi	Noun	feces,bottom
yaa	Interjection	aah
ab	Noun	father
maŋgi	Noun	coconut
simblim	Verb	lay.on?
famli	Noun	family
qemar	Noun	child
waŋ	Noun	sibling
luta	Adverb	there
kis		kiss
bon		be.born
ubra		torn?
obi		
biqmboq		
po		think.of
tuŋ		dig
jjray	Verb	pain?
stua	Noun	store
qŋeŋ		hang
Bubugoŋ	ProperNoun	Bubugong
qreb		
nambwan	Adjective	first
ain	Noun	spear
ngr	Verb	see.1pl.obj
bul	Verb	turn
e	Verb	2sg.imp
po		break,open
taŋar	Noun	father.i.l
seser	Adverb	quickly
qemen		
kuŋgu	Verb	prop
jojom	Adverb	near
gere		make,arrange
Agen	ProperNoun	Hagen
koroi	Verb	gather
Dumbu	ProperNoun	Dumbu
Watarais	ProperNoun	Watarais
Poipoi	ProperNoun	Poipoi
twentieitpla	Adjective	twenty.eight
ula		fear
an	Noun	mother
msel		like?
qeq	Noun	armpit
il	Verb	bear
Mada	ProperNoun	Mada
dur	Verb	follow
niŋga	Pronoun	2pl
qaŋg	Verb	come
to	Verb	do?
Madaŋ	ProperNoun	Madang
aŋ	Noun	top
kal		
eku	Verb	2pl/3pl.hod
gebi		
Emil	ProperNoun	Emil
tuqri	Adjective	short
matmat	Noun	grave
dir	Noun	hand.drum
toror	Verb	meet.trouble?
bom	Noun	sago,biscuit
qle		know
s	Verb	stay
Blŋai	ProperNoun	Blngai
Polo	ProperNoun	Polo
griq	Verb	tighten
pes	Adjective	first
qelagu	Adjective	young?
a		voc
soql	Verb	carry.on.head
jajo	Pronoun	1sg.poss
uŋguy	Verb	start.fire
Jajul	ProperNoun	Jajul
mojubu	Noun	mouth
Maikat	ProperNoun	Maikat
mom	Noun	baby
gublig	Adjective	dry
oho	Interjection	haha
gatuŋga	Interjection	closed
Koi	ProperNoun	Koi
bimboq	Verb	hit
Walium	ProperNoun	Walium
gati	Noun	head
groŋ	Verb	insert
lu	Particle	here
Abul	ProperNoun	Abul
kaŋglu	Noun	work,work
umsi	Verb	2sg/1pl.fut
tuŋ		there?
Maragum	ProperNoun	Marakum
ileven	Adjective	eleven
brei	Verb	throw
war		cry
liq	Verb	surround
namor	Noun	fat
sla	Noun	vine
guba	Noun	cockatoo
teti	Adjective	thirty
kubai		hug
btem	Verb	put?
kuleu		talk
Kulel	ProperNoun	Kulel
quraqa	Noun	village.loc?
qrqaq		crackle
qapo	Adjective	white
puŋgoŋ	Noun	eagle
waliŋ	Noun	sibling.i.l
demub	Noun	door
bre	Verb	toss
ko	Noun	neck
masis	Noun	lighter
Rasia	ProperNoun	Russia
kuli	Verb,Noun	stump,start?,bottom
giw	Noun	dye
Garim	ProperNoun	Garim
gombor	Noun	back
soŋ	Noun	ghost
ando	Pronoun	3pl
mnen	Noun	kind,behavior
njram	Noun	chest?
jnjeŋ		draw,tell?,do.thus?,move.thus?
manam	Verb	educate
qabru	Noun,Adjective	good,right.hand
dula	Noun	hornbill
goi	Verb	cook.for?
kroŋ		wilt
Togol	ProperNoun	Togol
gubu	Adjective	male
kabal	Noun	cousin
Wararam	ProperNoun	Wararam
muŋ	Noun	grandfather
ŋam gusa	Noun	boat
Mul	ProperNoun	Mul
mal	Noun	snake
kabu	Verb,Noun	cover?,cover
kendei	Verb	count
uñan	Noun	grass.sp
do	Noun	skin
inaudible	Interjection	inaudible
qutu	Verb	get.up
at	Noun	hat
qujaq		one
krrŋ	Noun	tree.sp
qoq	Verb	break
btetb	Verb	put?
ailens	Noun	highlands
guŋgreŋ	Verb	hang
Merien	ProperNoun	Merien
ss	Interjection	hey
sajim	Verb	charge
lawan	Noun	plain
rausim	Verb	remove
bes	Verb	2pl/3pl.rem.ss
qalm	Verb	stab
kublig	Noun	flood
waku	Noun	pandanus
a	Interjection	ah
qo	Noun	skin,cloth
parig	Adjective	near?,nearby
Sali	ProperNoun	Charlie
tariŋ		wait
tasol	Interjection	but
Diwai	ProperNoun	Diwai
Kerewagi	ProperNoun	Kerewagi
uget	Verb	forget
bakuy	Verb	carry
Morobe	ProperNoun	Morobe
mariŋ	Noun	forest
nisqo	Pronoun	2du
gtet	Verb	step.on
ulel	Noun	sand
Talita	ProperNoun	Talitha
kar	Noun	car
ain		throw
ŋariŋ	Adjective	hot
no	Pronoun	2sg.poss
yoqom		
ŋes	Noun	sweat
padal		suffer.disaster
kainkain	Adjective	all.kinds
daniŋ		sit.pl
mandrum	Noun	nose
asqo	Pronoun	3du
gambri	Noun	path
mlon	Noun	brush.turkey
Yowor	ProperNoun	Yowor
kas	Noun	tobacco
samting	Noun	thing
jirim	Noun	root
Kundyawa	ProperNoun	Kundiawa
qabau	Noun	edge
ŋoqli	Noun	wife
tenem	Adjective	completely?
ŋg	Verb	2pl.obj
Ibaqai	ProperNoun	Ibaqai
kubuŋ	Noun	canoe,trough
kwanjem	Noun	bean
ekrit	Verb	gobble
kimbi	Verb	2sg/1.ypst
nem		go.where?
Banare	ProperNoun	Banare
mr	Verb	tell.3sg.obj,tell
duŋ	Verb	detach
Bagi	ProperNoun	Bagi
amuŋ kai	Noun	vagina
gaja	Adjective,Noun	dirty,dirtiness
bobogu		under
kun	Verb	wander?
Malamu	ProperNoun	Malamu
ses	Verb	step.on
gambre		
knaga	Adverb	just
gam	Pronoun	1pl.agt
du	Noun	son
Semi	ProperNoun	Semi
ñau		peel
Garagasi	ProperNoun	Garagassi
noŋgo	Pronoun	2pl.poss
suq	Noun	paint
Siŋsiŋ Krik	ProperNoun	Singsing.Creek
waŋ	Verb	go.upstream
kaye	Interjection	thank.you
yiyi		try?
orait	Interjection	alright
guryo	Noun	crowned.pigeon
lowanem	Particle	because
qulel	Noun	walnut
si		loc
kil	Verb	spill
embreŋ	Verb	be.untied
jagara		all?
b	Verb	1sg.obj
krra		
pu		blow
masiŋ	Noun	rat
manag	Noun	louse
amuŋ	Noun	sibling,sister.i.l
qamu	Verb	come.1pl.ipfv
doqomna	Noun	nape
ye	Verb	1sg.ss?
lain	Noun	line,group
kain	Noun	type
raba	Noun	container
Mnjeŋ	ProperNoun	Minjim
Qotei	ProperNoun	God
sub	Noun	hole
kulig	Noun	heavy,problem
Silandu	ProperNoun	Silandu
bas	Noun	bus
bqal		things?,many?,all
duqni	Noun	daughter
yo	Interjection	hey
bala	Interjection	wow
kraq		
pasenja	Noun	passenger
u	Verb	inf
sios	Noun	church
qumbrem	Noun	bone
injr	Verb	see.3pl.obj
ŋodo	Noun	spirit
qubro		break
pnanaŋ		shoot?
qulu	Noun	morning.star
Don	ProperNoun	Don
misis	Noun	wife
fon	Noun	phone
sorory	Verb	rub
qasqai	Adjective	new
jali	Adjective	girl
dena		loc?
degum	Noun	door
qalubi		three
frut	Noun	fruit
misin	Noun	mission
uŋgoi		
baket	Noun	bucket
snag		boil
fok	Noun	fog
naintineitifaif	Adjective	1985
spak		get.drunk
les	Verb	?
bil	Noun	endpoint,end
nai	Verb	feed
kwaneŋ	Adjective	crooked
masil	Noun	fig.sp
ar		
wau	Noun	grandparent
Maŋga	ProperNoun	Manga
statim		start
gatuŋ		closed
Simbu	ProperNoun	Simbu
qilagu		
sapos	Particle	if
jagar		all
Pagambi	ProperNoun	Pagambi
ma		call.to
mak	Noun	mark
welu	Noun	valley
nabal	Noun	time,day
pag		tie,be.stuck
me	Verb	2sg.ipfv
nin	Pronoun	2sg.agt
ga	Pronoun	1pl
kulat		watch
qmuŋ	Adjective	black
qa		?
yum		
tal	Noun	house
bo	Verb	plant
torom		help
aqudi		finished?
kere		enough,be.full
eqlum		swallow
sore	Interjection	sorry
o	Particle	or
mubim	Verb	move
ples	Noun	village
Duwal	ProperNoun	Duwal
stret	Adjective	genuine
ginim	Noun	possum
isu	Adverb	morning
Rapael	ProperNoun	Raphael
yasili	Noun	urine
uriŋ	Noun	light,shine
ŋam	Noun	eye
jegem	Noun	spleen?
mleŋ	Adverb	dawn
mura	Noun	shell
Kwaliku	ProperNoun	Kaliku
u	Verb	do?
galas	Noun	binoculars
mnen		make,weave
naqal		two?
ñamul	Noun	sister.i.l
waya	Noun	crocodile
Sroi	ProperNoun	Siroi
Beyeŋ	ProperNoun	Beyeng
le		exph
demj	Verb	appear?
riŋriŋ	Noun	vine.sp
bab	Noun	uncle
jegem	Noun	eel
qajru	Verb	ruin
buqlu	Noun	behavior
mol	Noun	loincloth,penis
namba	Noun	number
bisir	Verb	peel
yo	Verb	burn,be.cooked
kay		
hausik	Noun	hospital
g	Verb	aux?
qumam	Noun	fish
Yali	ProperNoun	Yali
kawai	Noun	old.person
quyan	Noun	strangler.fig
misel	Noun	saliva,lust
soq	Noun	speech,make.noise
kulel	Noun	walnut.sp
bu		many?
wig	Noun	seedling
omon		
mate	Adverb	long.ago,please?
bla	Adverb	afternoon
Siŋin	ProperNoun	Singin
ke	Verb	2pl/3.hod.ss
ken	Verb	wander
Yoŋki	ProperNoun	Yonki
ñoqor	Noun	bean
tigen	Verb	do.3sg.hod
Keis	ProperNoun	Keis
tur		meet?
saŋal	Noun	crab
priq		wiggle?
bqol		
rel	Noun	rail
Banjombi	ProperNoun	Banjombi
mo	Verb	die.sg
yur	Noun	k.o.arrow
qunun	Noun	shadow,spirit
qo		adjz?
eitifaif	Adjective	85
pari	Noun	liver
lauqo	Postposition	like?
qjrq		lock
isoŋ	Noun	sorcerer
mali	Noun	flat.sand
maŋ		below
walwel		walk
klog	Verb	smell
wilwil	Noun	bicycle
Kainantu	ProperNoun	Kainantu
ŋiri	Adjective	small
tolet	Verb	forget
beu	Noun	brother.i.l
mar	Verb	talk
ot		float
siot	Noun	shirt
aqli	Noun	crayfish
sawali	Adverb	far
qalagi	Noun	tooth
agu	Noun	middle
qnin	Noun	taro
qamon		
Buliw	ProperNoun	Buliw
Glentali	ProperNoun	Glentali
jige		inside
faif	Adjective	five
elaq		no
abreg	Verb	hold
lelen	Verb	yell?
maket	Noun	market
maŋga	Adverb	outside?
nambawan	Adjective	first
qa	Verb	birth,bear.fruit
e	Verb	neg.lnk
woo	Interjection	whoa
Asas	ProperNoun	Asas
Tomas	ProperNoun	Thomas
yuwu	Noun	ember
sum	Noun	ashes
akt	Verb	send
damu	Noun	meat
dur	Noun	comb
pururu		fly
ne		some?
bem	Noun	ghost
aqa	Interjection	okay?
meneŋ	Noun	stone,money
laŋru	Noun	forehead,face
Kud	ProperNoun	Kud
sur	Verb	push
kunjo	Noun	game
mleq		be.clear
Tiga	ProperNoun	Tiga
amsi	Verb	eat.2sg/1pl.fut
bbnam	Noun	ant.sp
jaqli		laugh
wali	Adjective	long,long
lilil		two
nera	Adverb	where
gi	Noun	fruit
e	Verb	aux
ugodi	Adjective	short
gai	Noun	uncle
ŋl	Verb	vomit
wa	Noun	rain
gunjlaŋ	Noun	bird.sp
qjaq	Noun	spear
Gabir	ProperNoun	Gabir
win	Noun	turtle
kuŋu		prop
utik	Verb	leave
kolta	Noun	asphalt
yombo		steal
nambatu	Adjective	second
kombi	Verb	1pl.ypst
Kagilo	ProperNoun	Kagilo
maqai		many
yulu	Noun	possum
umbi	Verb	2sg/1.fpst
aqar	Noun	break
bla		again?
qeli	Adjective	big
ma	Verb	hit
Qambaŋqa	ProperNoun	Male
opis	Noun	office
Septemba	ProperNoun	September
Yagaum	ProperNoun	Yagaum
sos	Verb	step.on
qureq	Verb	break
Briŋ	ProperNoun	Bring
Stesin	Noun	station
ge		
taun	Noun	town
kuŋgruŋ		thunder
dubuy	Noun	child?
dndaŋ		fiddle
wolge	Noun	lychee.sp
mm	Interjection	yes
eb	Verb	2pl.imp,3pl.imp?
wo	Noun	sore
burbar		lie.across
bar	Noun	hand,shake.hands
lala	Noun	tailfeather
knaŋ		forget
tigini	Adjective	straight
aqandeta	Interjection	thats.it?
wo	Noun	war
muri	Noun	breath
qubol	Noun	grandparent?
ubi	Verb	2pl/3pl.fpst
yuwen	Noun	tulip
ti	Verb	do.thus
skrin	Noun	screen,windshield
qaml		
gumbla	Noun	husband
qnam	Adverb	daytime
Kamblo	ProperNoun	Kamblo
traipela	Adjective	huge
muŋgol	Noun	banana
wagur		cry
qataŋ	Verb	bite
qal		be.ripe
u	Verb	3sg.obj?
Gili	ProperNoun	Gili
kyob	Noun	belly
aŋga		above?
Ramu Suga	ProperNoun	Ramu.Sugar
barig	Noun	wing
il	Verb	bathe?
traq		only?
yaqalm	Verb	pour
kaikai		welcome?
gam	Postposition,Noun	path,by?
Melki	ProperNoun	Melki
tutulot	Noun	firewood
murui	Verb	carry
gab	Noun	fly
so	Noun	fig.sp
sambom	Noun	place
pwai		buy
bol	Noun	pig
qjriqa	Verb	go.in?
kir	Noun	blood
wiŋ	Verb	push
toqo		such?
bum		?
a	Postposition	agt
tultul	Noun	tultul
plantesen	Noun	plantation
Bari	ProperNoun	Bari
oda	Noun	order
pplag	Verb	explain?
yar	Noun	year
qlaiko	Adjective	huge
se	Noun	skin
turtu	Verb	unite
ureq	Noun	crash,ocean.break
yoqoma	Pronoun	1du.agt
rais	Noun	rice
sayam	Noun	plate
ande	Particle	dem
qel		
ko	Particle	top?
walel		
mandum	Noun	orphan
juqey	Noun	cassowary
nj	Verb	3pl.obj
tit	Verb	pull
imba	Adverb	tomorrow
men	Verb	2sg.rem.ss
magi	Noun	tail
ko	Verb	2pl/3.hod.ss
ausi	Noun	family
pe	Verb	take
roŋen		
qil	Noun	decoration
kwal	Verb	go.down
tuol	Noun	egg,testicles
qut	Verb	fight
stat		start
ut	Noun	think,thought
ge	Noun	finger,arrow,fruit
dubul	Noun	thigh
blil	Noun	wild.sugar
pu	Verb	break
Lei	ProperNoun	Lae
qalamjr	Verb	not.want
paq		pick?
Sipik	ProperNoun	Sepik
puplug		return
toq		
koŋkoŋ	Noun	taro.sp
tiqo	Adverb	also
wob	Noun	pot
soq	Verb	lift
qura		finish
taim	Noun	time
tenkyu	Interjection	thank.you
e	Interjection	hey
yabi	Adverb	yesterday
da		refl?
buŋ		meet
taqlbe	Noun	other.side?
weq	Verb	spill
Enru	ProperNoun	Andrew
tiŋ		stand.sg
quben	Noun	thing
dul	Noun	vein
mabrag		die.pl
em	Verb	?
nene		various?
Lia	ProperNoun	Lia
klen	Noun	clan
senisim	Verb	change
buga	Noun	whiteskin,spirit
sqoq		bubble?
braŋgar	Noun	star
qoq	Noun	whiteskin
Suqbi	ProperNoun	Suqbi
blai		
yu	Noun	garden
Malesusurum	ProperNoun	Malesusurum
ekum	Verb	2sg/1.hod
saman	Noun	outrigger
saŋ	Noun	lower.leg
b	Verb	pl.imp?
bail	Adjective	strong,be.strong
malil	Noun	vigil
qneneŋ	Adjective	very.small
ai		?
bre	Noun	top,branch
jo	Verb	clear
unun		sleep.pl
Tagun	ProperNoun	Tagun
seqy	Verb	try
dabu		remove?
tg	Verb	tie
temt	Verb	light
Baŋu	ProperNoun	Bongu
liqiŋ	Adjective	many
mŋai	Verb	cheat
qsqa	Noun	play,game
Mande	Noun	Monday
un		sleep
gumun	Noun	husband
Tapo	ProperNoun	Taop
tuq		sink
sapor	Noun	iron.axe
sikspela	Adjective	six
gli	Noun	place
do	Verb	share,count
boleji	Noun	dolphin
uj	Verb	go.in?
prru		lose.control?
gur		run
em	Interjection	that
gali	Noun	woman
uta	Verb	proh?
ya		
wej	Verb	hold
ñaqam	Noun	jaw
paŋy	Verb	husk
aqodi		
uŋgai	Adverb	only
laŋ	Noun	sky
ag		sell
yulu	Verb	pass
kol	Verb	tie
Rereu	ProperNoun	Rerau
qe	Verb	hear
kela		
kiap	Noun	kiap
seŋ		pick
Yembun	ProperNoun	Yembun
maman	Noun	father.i.l
kuraŋ	Noun	rack
Buram	ProperNoun	Buram
Gaulai	ProperNoun	Gaulai
Kaliku		
waq	Verb	go.up
kulu	Adverb	night
gegre	Adverb	well?
ogoq	Adjective	short
kwaji	Noun	penis
umu	Verb	1pl.ipfv
gugrus	Noun	corn
gom		
yoqo	Pronoun	1du
tum	Adverb	?
yumbar	Noun	bamboo
qaqa		exph?
quraŋ		be.stuck
mimi	Adverb,Noun	long.ago,first,front
kol	Noun	bowstring
balus	Noun	airplane
jenresen	Noun	generation
t	Verb	caus
gos	Verb	tie
qaq	Noun	sap
sait	Noun	side
maŋgu		below?
sa		wipe
buq	Noun	sprout
tatai	Verb	scatter
taraq		become?
qaŋgraŋ	Adjective	dry
tumbaŋ	Noun	unite,gathering?
tor	Verb	sweep
Kaleks	ProperNoun	Kalex
to	Noun	chicken
bga	Adverb	later
basa		finish
Yamban	ProperNoun	Yamban
kosoŋgor	Noun	neck
usqel	Noun	navel
lapun	Noun	old.person
was	Noun	vagina
Soŋgo	ProperNoun	Songo
walu	Noun	pumpkin
imbin	Noun	sugar
doqol	Verb	cough
wiaqan	Noun	spirit
a	Noun	voc
druŋ	Noun	girl
jaji		
tula		thus?
blau		swell
roŋon	Noun	wind
mililiŋ	Noun	lightning
Lablab	ProperNoun	Laplap
Kior	ProperNoun	Kior
qsaq	Verb	whittle
seken	Adjective	second
pot	Verb	break
gi	Verb	?
tripela	Adjective	three
ut	Verb	leave
na		?
Ø	Verb	3sg.obj
gusa	Noun	log
kubul	Noun	widow
Tunbi	ProperNoun	Tunbi
dijasta	Noun	disaster
ye	Pronoun	who
trausis	Noun	trousers
abib	Noun	sweet.potato
pawa	Noun	power
stori	Noun	story
qawar	Verb,Noun	shoulder,carry,branch
bal	Verb	chase,drive
jar		run.pl
lolol	Verb	be.ignorant
mŋgr	Verb	tell.2pl.obj
powq		bang
gabra	Noun	slope,creek
Marmer	ProperNoun	Marmer
bala		many
qure	Noun	village
ara	Noun	shelf
tma	Noun	man
Damun	ProperNoun	Damun
Jimi	ProperNoun	Jimmy
guno	Noun	limbum
wabi	Noun	cloud
bal		spill
endei	Verb	prepare
sup		husk
oqbi	Verb	?
quŋgur	Noun	island
sbal	Noun	wallaby
tiŋgriŋ		stand.pl
sam	Verb	go.east
doqa	Verb	be.sick
yaŋs	Verb	wash
ul	Verb	?
bar	Noun	salt
dadamu	Noun	body
kyo	Particle	q?
twolv	Adjective	twelve
para		happy?
kodegisiga	Noun	tree.sp
lil		
jam	Pronoun	1sg.agt
laŋgaŋ	Noun	spider
sak	Noun	shark
jambu	Noun	cucumber.sp
jjgel		overeager?
bat	Verb	put
braq		tear,multiply,break
bloŋ	Verb	close
nanari		confused
mobloŋ	Noun	flying.fox
Mareu	ProperNoun	Mareu
Tablou	ProperNoun	Tablou
Kamon	ProperNoun	Kamon
qidi	Adjective	big?
kot		litigate
saqare	Noun	piece.of.wood
bag		some
baqli	Verb,Adjective	bad,very,worsen
mnjr	Verb	tell.3pl.obj
Poin	ProperNoun	Point
n		?
btet	Verb	put?
yiyi	Interjection	no.way
tombol	Noun	joint
waliku	Adjective	long
e	Verb	eat
qaneŋga	Noun	small
[...]		emph?
qaqru		pluck
bui	Noun	du
taŋgi	Noun	place?
wit		throw
swi		empty
se	Verb	1sg/3sg.ipfv
tuawas	Adverb	two.hours
kabum	Noun	cordyline
qamen	Verb	come.2sg.rem.ss
qo	Postposition	?,com,temp
gibi		?
maŋdamu	Noun	land
mansli	Noun	dry.sand
et	Verb	1sg.rem.ss
seqli	Noun	father.3.poss
kamul	Noun	bird.sp
m	Verb	?
taŋga	Interjection	open
nbr	Verb	see.1sg.obj
Bndaqagu	ProperNoun	Bndaqagu
tag	Verb	fetch
yo	Noun	betel.pepper
atu	Noun	piece.of.wood,piece
siwi	Noun	shell,dust
koli	Verb	draw
sŋgrem	Noun	fingernail
gurgur		run.pl?
olsem	Particle	like
mun	Noun	festival
mob	Noun	mouth,respond
qasi		throw?
Siman	ProperNoun	Siman
Abui	ProperNoun	Abui
ni	Pronoun	2sg
Pita	ProperNoun	Peter
sarig	Adjective	old
lŋgaŋ		jump
sroŋ		red
maŋgimar	Noun	heart
kom	Verb	2sg/1.hod.ss
yo	Interjection	no
Aŋari	ProperNoun	Angari
okei	Interjection	okay
ŋlaŋ	Noun	brain
kumbaŋ	Noun	lizard
abu	Noun	father
mʔm	Interjection	uh.huh
i	Verb	give,aux
qumar		
yaqo	Adjective	wet
Montolom	ProperNoun	Montolom
jŋgwai		only
Laloq	ProperNoun	Lalok
as	Noun	bird
siks	Adjective	six
ja	Pronoun	1sg
Yomi	ProperNoun	Yomi
kuboli	Noun	dance
mar	Adjective	unripe
sqor	Verb	carry,catch
na	Particle	here?
Buyam	ProperNoun	Buyam
sre	Noun	knife
doqo	Noun	sickness?
ŋamgi	Noun	eye
i		take.from?
minits	Noun	minutes
jqoi	Noun	cassowary
Nau	ProperNoun	Nau
bqali		all?
kastam	Noun	custom
kubu	Noun	deep
jujum		
gu	Postposition	loc?
umbu	Noun	fig.sp
qubuŋ	Noun	hole
greq	Verb	scold
Naneb	ProperNoun	Naneb
bal	Verb	remove?
es	Verb	aux?
go	Verb	cook,weave
nŋgreŋ	Noun	knowledge,write
agrag		be.angry?
a	Postposition	ins?,loc
gwawa	Noun	guava
eqrit		
sotpela	Adjective	short
nuŋgud	Adjective	cold
indi	Interjection	there.it.is?
emblem	Noun	middle
palagu	Adverb	now
daŋ	Noun	yam.stick
qoloŋ	Noun	bag
yasai	Verb	scrape
mama	Noun	grandmother
magli	Noun	stomach,inside,bay
kele	Noun	thunder
pna	Noun	bow
ari	Verb	1sg.fut
kuleŋ	Noun	pillow
bisaŋal	Noun	crab.sp
wos	Noun	wild.sugar
Kubu	ProperNoun	Kubu
ma	Noun	shade
qubroq	Verb	break?
groq		burp
onde	Interjection	yes
ndeta		finished?
gsru		spit
kobo	Adjective	elder,big
yag	Noun	water,petrol
