amigoí = friend
báɲó = bathroom
bóté = boat
bālī = small
chikuíina = thief
cinalɛʲ = baby dog
cinaʒii = male dog
cìkà = put.on
cìnaiN = my.dog
cìʒāká = fish
cítɔ̀lɛ̀ʲ = baby calf
cīkàN = 3M.SG
cīkʷá = night
cīkʷí = water
cīkʷī hà = hot water
cīkʷī vīsī = cold water
cīsī = under
cʰikɔɔ = tamale
cʰuNcʰa = atole
cʰìnàhíʔí = female dog
gìtárá = guitar
ha᷄kʷítí = always
hiʔi = female
hutʲíí = priest
hàkà = just
hàʃìtà = hot
hàʔʑí = child
hàʔʑíì hàʔʑíí = great grandkid
hàʔʑíì híʔì hàʔʑí ʑíìN = the daughter of my male son
hàʔʑíì Níʔáā = female child
hàʔʑíì ʑíʔí hàʔʑí = the son of the male child
hàʔʑíìN níanì = female grandchild
hàʔʑíìN tātāì = my stepfather's child
hàʔʑíìN ʃíkwáì = great grandchildren
hàʔʒī = child
hàβì = 
há = yes
hákàkà = drive
hákànà = throw
hákʷàʔà = study
hánānā = raise
hánāʔà = point
hásì = nephew
hávì = rain
háà = hot; fresh
háʔma᷄ʃītʰà = tortilla.cloth
háʔmà = clothes; cloth
hìkò = neck
hìNʔndʲì = butt
hítí = cheek
hòkò = shoulder
hīkò = tall
hīì = happy
hīʔvíNt͜ʃīkì = cow.poop
hūkété = toy
jɔ̀ɔ̀ = month
jɔ̄ʔɔ̀ = here
kyàʔā = brother
kàfê = coffee
kàhí = close
kàndʲʒáá = slide
kàNʔní = kill
kàNʔnò = break
kàNʔàN = tell
kàtʲʰí = scratch
kààʃí = stab
kàá = metal
kàává = cave; canyon
kàʃì = crush
káháɲāmànì = implore
kámá = come
kánàʔāN = insult
kárétà = cart
kásāā = arrive
kávà = roll
káání = slimy
káává = make.hole
kááváʒāβì = dig.hole
kááváʒītò = carve.wood
kìvì = day
kìvì vítí = today
kìxí = pot
kìʔví = enter
kívikwāʧí = Female cousin
kíākwāʧí = male cousin
kîcì = animal
kòò kàāN = rattlesnake
kórá = fence
kóótɕí = pig
kùndahi = dislike
kùtóó = like
kùtɕú = move
kùùná = open
kúj = I.am
kúkàʔà = embarassed
kúkòó = pull
kúndʲèʔé = proud
kúndʲīsī = wear
kúndʲʰáká = guide
kúndʲʰáá = lean
kúNndìtɕì = stand
kúNníN = yesterday
kúNùN = drop
kúnēNʔēN = carry
kúNʔùN = go
kúNʔùNsìíká = travel
kúNʤūʔù = lie.down
kúù = happen
kúùkù = gray.bird
kúú = hort
kāhā = do
kāldō = soup
kāmīsétá = shirt
kānākàà = sit; stay
kāNʔndʒā = cut
kāNʔndʲʒī = pop
kārɔ́ = car
kāsìvì = noon
kātā = sing
kātāsáʔá = dance
kātʲā = dig; pick
kāā = calcium powder
kāāmā = fast; soon; quickly
kāānī = hit
kāɲìì = long
kāʔvī = count
kāʔvī = read
kēNʔéN = give
kīnì = ugly
kīītʲī síkwàā = bat
kīʔvì = sick
kōʒòhó = ride
kōʔò = plate
kūhíkí = play
kūna᷄ = tired
kūndàà = understand
kūnēʔē = hold
kūnī = yesterday
kūsī = white
kūātī = twins
kūūsī = eat
kūɲì = want
kʰáā = over.there
kʰáʔnō = big; fat
kʰìvì = name
kʰìxīlóʔò = cup
kʰíìtʲʰì = animal
kʰíìɕì = sleep
kʰííɕī = make
kʰòò = snake
kʰóòlò = turkey
kʰùùní = meat
kʰāmì = burn
kʰāātʰó = tie
kʰāātʲì = shadow
kʰāʔà = base; butt
kʰōòmì = four
kʰōʔō = drink
kʰūt͜ʃárá = spoon
kʲʰàʔá = sibling
kʷànānā = move.up
kʷáá = blind
kʷááN = yellow
kʷáʔá = leave
kʷììkà = comb
kʷìʲà = year
kʷíì = green
kʷāʃì = squish
kʷāʔà = many
kʷāʔá tīɲùN = stars
kʷēē = slow
kʷēʔè = mad
kʷēʔè = sickness
kʷīkò = hungry
kʷīʔí = fruit
kʷʰáàʑì = horse
kʷʰáʔá = red
la᷅ʔlā = goopy
leìì = baby child
lámbá = stomach
lánsá = projectile
lápì = pen
lásá = bone
láá = bird
lèe = baby animal
léékà = bag
lòtīʔī = few
lómá = hill
lóóβó = wolf
lóʔò = small; young
lāndyī = navel
lāndò = lie
lānʒī = belly button
lāsà = skinny
lāā ndʑáá = bluebird
lāā sīkwàā = owl
lētʃúúɣá = lettuce
līvì = beautiful
lōōsó = fox
mbáà = godfather
mànì = spoiled
máàrì = Mari
mááskārā = mask
méN = the
mésá = table
méʔènà = themselves
méʔèrà = himself
méʔèɲà = herself
mììnó = epazote
mēskâl = mezcal
mēíN = myself
mēúN = yourself
mēɲāsītà sáʔá = dancer
mōNɲéká = doll
mɛNií = 1SG
mɛNndɔ = 2PL
mɛNu = 2SG
mɛ̄ɛ́ = 1PL
mɛ̄ɛ̄Nɲá = 3F.SG
mɛ̄ɛ̄Nɾá = 3M.SG
m̄ʔḿ = no
na kosini = unknown person
naƷíko = seller
ndyéé = thick
ndyútɕì = bean
ndàkàtùNúN = request
ndàkú = hominy.soup
ndànèʔé = harvest
ndàvà = jump
ndàà = straight; true
ndàʔá vāʔá = right
ndàʔáʒítò = branch
ndávà = fly
ndáʔà = arm, branch
ndáʔà = pencas
ndáʔà bālī ʒìtɔ̀ = tree leaf
ndáʔà ʒìtɔ̀ = branch (tree)
ndáʔβí = poor
ndìí = dead
ndíìɕì = 
ndíʔà = cliff
ndòʔō = clay.brick
ndóhò = breast
ndókò = chirimoya
ndóʔó = 2pl
ndô = sugarcane
ndùùsà = shoe
ndāsī = wet
ndāʔà = arm
ndāʔʒì = clay
ndēʔé = handsome
ndītìNndīví = sky
ndītīNndīí = sun
ndīví = daylight
ndīɕí = blue
ndʑììβà = skin.cracking
ndʑììβì = egg; genitals
ndʑíìɕì = corn
ndʑííɕí = how
ndʑù = 1pl.excl
ndʑùʔù = we.excl
ndʲíhō = carry.on.back
ndʲívá = tamarind
ndʲíìkà = banana
ndʲíʔíβá = everything
ndʲúsá = vomit
ndʲʰātí = wait
nd͜ʒáʒì = sauce
nihíì tātāì = my father's wife
nihíì ʃítoì = uncle's wife
nihíí hàʔʑíì = the wife of the male child
nikunikiʃi = thanks to her
nàkàvá = twist
nàkèʔēN = catch
nàndóhó = forget
nànʤūsá = melt
nàsítā = musician
nàà = hi
nàʒáátá = elders
nákátʲá = wash
nákáání = unbuild
nákèʔúN = take
nákùNʔū = remember
nákāʔʒī = painting
nákʰávà = turn
nákʰává = fall
nákʰùNʔúN = inside
nákʰāvà = roll
námánì = mother.in.law
nándìʔì = later
nánìʔì = find
náNʔáN = early
násano = older lady
nátìvì = appear
nátʲíìhāʔmà = sew
návēlā  ʒātáí = great grandmother
náànì = chayote
náá = let's
náʔá = early
nì = salt
nìkʰí = what
nìsēNāN = buy
nìʔndʲàá = bruise
níaʒìví = person
níìN = cob
níìN = skin; leather
níʔmà = smoke
nî = masorca
nòóvísí = cold place
nùNndʲìvá = Oaxaca
nùNʔúN = tooth
núNβàá = down.there
núùN = face
nā sītā = person who sings
nā ʤātáí = my old folks
nāhàkʰà = mix
nāhàmá = change
nākà = 3PL
nākāʔʒī = draw
nānávēlā = grandmother
nānā = mother
nānā kēēn = stepmother
nānāìN = climb
nāNʔā = morning
nātʲāā = write
nāt͜ʃúūN = useable.things
nāvàlí = girls; children
nī = pst
nīmà = stupid; silly
nīt͡ʃìt͡ʃì = ripe
nīʔí = loud
nōòNnì = maize
nōòNní = zucara
nūùN = top.of
nɟìcīsí = at.bottom
nɟùùsí = chicken
nɟúùtɕʰì = bean
nɟāká = there
nɟīvā = guaje
nɟɪ̀ɲākà = there
nʤiNʃi = corn
nʤáʤì = mole
nʤɪvɛʔuN = thank you
nʤɪvɛʔì = thank to me
nʤɪvɛʔɛmei = thanks to me
nʤɪvɛʔɛN = thanks to us
nʤɪvɛʔɛndɔ = thank you (2pl general)
nʤɪvɛʔɛniN = thank you (honorific)
nʤɪvɛʔɛɲa = thank you (to her, indirect)
páání = rebozo
píínó = pine
pósò = well
púNtá = point
pītááʑá = pitahaya
pūlséɾá = bracelet
pūùmà = puma
rēpóòʑò = repollo
saʔa = how cobb is prepared (nixtamalization)
sa᷅á = new
sàtà = back
sàtí = spicy
sàʔà = about; foot
sàʔávēʔē = wall
sàʔáʒā = theme
sáʔàN = taste
sèʔè = violent, immoral
sèʔē = son
sìò = griddle
síjá = chair
síkà = walk
síkí = far
síkʷǎvìtì = tonight
síN = and
síndèʔè = look
sítí = guts
síɲì = know
síʔī = die
sātʰī = pants
sēβóójá = onion
sī = 3sg.honorific
sīkā = far
sītó = bed
sīʔíní = afternoon
sʔeè níanì = male grandchild
ta kʰáʔnō = messenger
tyìsī = stomach
tàtà = medicine
tàà = hi
tá = when
tákàN = hang
tákʷèʔè = injury
támánī = father.in.law
tásano = older male
tásá = cup
tásá = lightning
tátɕī = air, wind
távēlᴐ ʤātáí = great grandfather
táà = earthquake
tìkìvā = butterfly
tívì = visible
tòʔìīní = espinozo
tòʔó = god
tóhòʔō = earring
tónó = tone
tóʑòō = carrizo
tùNʔúN = word
túnì hà = extra.hot
túnì ìʔníʃìtà = boiling.hot
túNʔúN = pull.weeds
tútí = 
tā kīʃī = person who makes
tāndāʔá = push
tāntāʔá = marry
tātávēlᴐ = grandfather
tātā = father
tātā kēēn = stepfather
tāʃì = quiet
tāʔví = break
tēʔé = intelligent
tīkʷí t tīɲùNʔúN = ocean water
tīkʷí váʔà = potable water
tīkʷí ívà = bitter.water
tīkʷīí = water
tīɲùN = star
tīɲùNʔúN = ocean, sea
tīʒāʔá = eagle
tōʑùūsā = pine.sp
tōʒìká = basket
tōʔò = waist
tūNʔúNhàvì = Mixtec
tūūnà = prickly.pear
tūɲì = very
tǔN = black
tɕááN = forehead
tɕèʔē = plant
tɕìkāà = put.in
tɕìnìì = butterfly.weed
tɕìnóNà = put.on
tɕíhèʔé = hide
tɕāʔʒì = rotten
tɕīndòòkò = chicatana
tɕīndʑàʔʑà = peach
tɕīndʑàʔʑī = peach
tɕīndʑììtɕí = avocado
tɕʰàā = men; man
tɕʰáāN = make.tortilla
tɕʰíítós     = cat
tʃííN = nail
tʰʲúútʰí = paper
tʲìkáā = he
tʲìkāāmā = jicama
tʲìmīí = bumblebee
tʲìndʑīīkí = nogal
tʲìíN = mouse
tʲìʑīīkí = seed
tʲílàlā = urine
tʲíì = grab
tʲīkʷìtʲī = potatoes
tʲīlóʔò = boy
tʲīmjàʔá = demon
tʲīndòò = spider.sp
tʲīndʑàʔʑí = peach
tʲīvàlí = boys
tʲīīβī = bite
tʲūkū = again
tʲɛmpɔ vīsī = cold season
tʲɛmpɔ xàvì = rainy.season
tʲɛmpɔ ìʧí = dry.season
tʲɛ́mpɔ́ = time
tʲɛ́mpɔ́ jàtà = olden time
tʲɛ́mpɔ́ sàtà = behind
tʲʰákú = alive
tʲʰìkʷʰàá = orange
tʲʰìndʑìkì = cow
tʲʰìná = dog
tʲʰìnááná = tomatillo
tʲʰīβììtʲʰí = prickly.pear
tʲʰūʑùùsí = plant.sp
t͡ʃàndó = hi
t͡ʃàà = hi
t͡ʃāgà = more
uNna = eight
usi = ten
vàá = down
vìló = soft
vìsí = cold
vìʃì = sweet
víkò = cloud
víNtíN = now
vāʔá = good; correct; nice
vāʔá = yes
vāʔá ní = yes
vēéN = heavy
vēʔē = house
vīNtìN = today
vīsì = cold
vītá = bend; bendy
vītí ícàN = right now
vīʃá = wet
vōlà = bowl
wéèslì = Wesley
xusa = lazy
xìʔví = poop
xìʔī = leg
xíkì = necklace
xòʔō = ear
xóʔó = deaf
àNhìN = delicious
ánímà = heart
ááxó = garlic
áʃìnì = hat
è = 1pl.incl
éɾífísíó = building
ìtɕìkáʔnò = road
ìtɕí = dry.season
ìt͡ʃí = dry
ìxā = day.after.tomorrow
ììʒá = sour
ìʒó = fear
ìʔīní = hot
ícàN = tomorrow
ínūúN = same
ítɕì = road; path
ítʲí = left
ívà = Bitter
íìɲò = thorn
ííló = rabbit; knot
ííN = one
íítá = flower
íítá sìʔííní = afternoon.flower
íñí = inside
íītʲī = candle
íɕì = hair
îN = POSS; 1s
ðááɲá = Daña
ñálóʔò = girl
ñáʔà = woman
úNʔûN = five
úúhú = deer
ārdīìʑà = squirrel
ēspéhó = glass
ēèβè = two
ēʔvè = hurt
īNtàN = tomorrow
ītā ndʑìí = marigold
ītʲààN = tomorrow
īt͡ʃì = thirsty
īt͡ʃì = way
īt͡ʃìN = thirsty
īìN = nine
īìɲò = six
īīnī = 
īītā βíìlò = geranium
īītʲā = grass
īŋgā = other, different
īʃí nùN = eyelash
ūùnì = three
ūùsà = seven
ɔ́ɾá = time
ɛvɛ mɛNndɔ = You all (two)
ɛ̄stāsiʲɔ́N = season
ɟĩki = squash
ɲahiʔi = wife
ɲàkáā = thing
ɲàndívà = Oaxaca
ɲàNndīví = Earth
ɲàNt͜ʃǐví = fire.fan
ɲànī = half
ɲàà = she
ɲáá = what
ɲìì = salt; blood
ɲíɲí = hail
ɲùNtí = sand, gravel
ɲùù = palm.tree
ɲúNʔùN = fire; dirt
ɲúú = town
ɲúútɕí = honeybee
ɲúʔù = fire
ɲākòʔʒó = mexico; mexico.city
ɲāNkàN = 3F.SG
ɲāātátá = medicine
ɲāāʃēē = sharp.tool
ɲūN?úNvē?ē = kitchen
ʃita = tortilla
ʃiʃí = Aunt
ʃéʔè = bright
ʃìnì = head
ʃìnìvéʔé = roof
ʃìtì = nose
ʃíkò = smell
ʃítᴐ = uncle
ʃòòNʔó = money
ʃùkù = neice
ʃāʔnd͡ʒā = wide
ʃēèN = sharp
ʃīìn = side
ʑààβì = maguey
ʑákà = armadillo
ʑáʔà = chile.pepper
ʑííkì = squash
ʑíítò = tree
ʑíítò ndókò = chirimoya
ʑòòxō = metate
ʑóòkò = beehive
ʑóʔó = you
ʑúùkù = 
ʑúūlī = bird.sp
ʑīīβā = herb
ʑīīβā ʑééná = herb.sp
ʑōòxò = plain
ʑūùkù = plant
ʒiī  nanáì = my mother's husband
ʒiī = husband
ʒiī hàʔʑíì = husband of female daughter
ʒiī ʃiʃí = aunt's husband
ʒusa = corn meal
ʒuʔu = 1SG
ʒàà = white
ʒàʔvì = expensive
ʒákàʔà = play (music)
ʒáká = silo
ʒásì = squash bowl
ʒáà = ash
ʒáá = tongue
ʒáʔá = brown
ʒéʔé = door
ʒìtōsítā = instrument
ʒìtɔ̀ = tree
ʒìtɔ̀ = tree trunk
ʒìvì = edible.greens
ʒìʔví = scare
ʒíkí = barbacoa
ʒívì = woven rug
ʒókò = steam
ʒóxò = field
ʒóʔò = rope
ʒúkù = mountain; forest
ʒúkùʒíʔá = volcano
ʒúú = dew
ʒúʔù = edge
ʒúʔù = mouth
ʒúʔù tīɲùNʔúN = beach, shoreline
ʒābì = agave (plant family)
ʒācʰí = close
ʒākʷà = dirty
ʒātá = old
ʒātì = near
ʒāā = chin
ʒāā = song; music
ʒāākʰà = cob.silo
ʒāātʰà = plow
ʒāʃì = thin
ʒāʔà = pepper
ʒāβì = hole
ʒītʰò = wood
ʒīʔà = thread
ʒōō = moon
ʒūkʰūtʰátʰá = medicinal.herb
ʒūtʰātʰá = mirror
ʒūtʲá = river
ʒūt͜ʃì = knife
ʒūū = stone
ʒūū lóʔò = pebble
ʒūʔù = mouth
ʒɔʔɔ = 2SG
ʒɔ̄ʔɔ̀ = here
βàá = low
βálí = small.pl
βááká = cow
βììtʲá = cactus
βíìlò = cat
βíìsì = pineapple
βúùrrò = donkey
