0	take; do; hold; marry; be?
[...]	dur?
[...]	emph?
[...]	iter?; pl?; emph
[...]	very?; emph
a	ah
a	emph?
a	vagina
ab	father
aba	sibling; sibling.i.l
abaj	sibling
abreg	
abrig	hold; grab
abrus	melon
abu	sibling.voc
abun	thus
agam	cry
agle	?
agrag	be.annoyed.at
agu	trunk; edge
aguguqu	short.redup
agul	fall
aguquji	short
aguy	short
aha	aha
ailan	island.TP
aim	2s.fpst
ain	3s.fpst
ajai	grandmother
aji	1s
ajijiyi	1s.emph
ajim	1s.poss
ak	leave
akai	grandchild; grandparent
al	get.rid.of
al	now
al	open
ala	distribute
alam	now
alam	yam.sp
albim	help.TP
alen	right.now
alili	two?
aliti	two
aliw	day.before.yesterday
alue	point.geographic.feature
alul	destroy; get.messed.up
alwau	day.after.tomorrow
alwe	sharp; point
am	2sg.ifut
am	mother; mistress?
am	um?
amal	snake
ambak	disobey
ambembliŋ	middle.redup
ambiliŋ	
amblim	middle
America	America
an	3sg.ifut
ana	food?
ana	give.to.3d?; give?
andam	3s.poss
ande	this
andu	3s
andunduyi	3s.emph
anju	
aq	
aq	irr; irrːdes; irrːfut; irrːhort; irrːabil; irrːpur; irrːobg; irrːimp; irrːproh; irrːatmt; irr:pres.hab; irr:hypo; irr:cond; irr:inf; irr:supp; irr:dub; irr:so.that; irr:advis
aqa	here; now
aqai	back.direction; again?; toward.direction
aqai	neg?; ?
aqai	topic?
aqal	bow
aqale	ripe
Aqalu	Aqalu
aqan	wife
aqane	?
aqaqai	?; again.redup; all?; just.only; dur?
aqar	hit?; whittle?; rest?
aqen	take.3s.fut?
aqle	?; neck
aqreur	kill.completely
ar	
are	liver
aren	no
arenen	?
areŋ	thunder
ari	
aria	okay
ario	ario
aro	outside
as	bird
asa	great.grandfather
Asel	Asel
asen	?
at	hat.TP
at	put; do; build; leave; prepare
ati	thus
atiu	do.thus
augul	fall
Australia	Australia
awal	breast
away	buy
awaya	buy.des?
awu	rain
awubi	cloud
awul	tree.sp
ayaŋ	yam
ayi	old
añi	big
añiboro	big
añiboroŋ	
añiñi	big.redup
aŋ	be.confused?; go; go.around; open.up
aŋam	tree
aŋamuru	underneath
aŋga	anchor.TP
aŋgr	put.3p
aŋgumu	right.arm
aŋu	stand.up
b	1s.obj
bade	wing; side
bagaleo	on.a.rack
bagri	hair; leaf
bail	be.strong
bajin	steal
baku	carry
Balama	Balama
balan	23ns.?; 23ns.fut; 23ns.rpst
balaŋ	speech
bale	root
bambariq	flap.wings
ban	23ns.rpst/fut; 23ns.fut; 23ns.rpst
bane	branch
Bang	Bang.place
banis	fence.TP
baqain	run
baqala	frame?
baqin	flow.fast
baqla	exchange.partner
baqla	platform; bed
bar	hold; shake.hand
bara	shake.hand
barata	brother.TP
baru	shake.hands
barum	signal.drum
basa	be.finished
basis	barge?.TP
batit	pull
batiti	
bauqu	hit
Bawin	Bawin
be	spec; q; also
beb	23ns.prs
beben	23ns.hab
beble	other.side
beg	bag.TP
bei	another
bek	respond
bekim	respond
bele	place
ber	23ns.prs
bere	top
berem	great.great.great.grandfather
beren	23ns.prs.iter?
berlan	23d.prs.iter
bes	23ns.r.ss
besen	23ns.prs.hab; 23ns.r.ds
beslan	23d.prs.hab
betaqt	tackle
beu	brother.i.l
bi	?
bi	feces
bia	fire
bibraqt	tear; break.through
bibriŋ	other; various
bil	mark?; stop
bilaw	swell
Bilbil	Bilbil.place
bile	there?
bileŋ	good
binda	
Bindaŋ	Bindang
bineu	later
binja	split.wood?
bisañi	bush
bisi	busy.TP
bisnis	business.TP
bisoŋgum	naked
bitoq	jump
biw	?
Biwo	Biwo
blut	blood.TP
bo	or?; place?; epist.uncert
bo	plant
boam	sago
boboqole	bad.redup
Bog	Bog
bokene	side
bokonom	meat
bola	genitals
boli	breadfruit
bolumboslo	toad
bon	?
bon	ironwood
Bonem	Bonem
boq	hungry?
boqol	in.vain
boqole	bad; intens
boqole	try?
bor	salt
boro	elder; big
bosboi	boss
bosim	control.TP
botol	bottle.TP
botuqt	cut
boyo	dessert
Boŋgu	Bongu
Boŋu	Bongu
briŋ	emph
briŋti	other
brut	pierce
bu	?
bu	cane
buain	star
bubulw	translate
buga	spirit; white.person
buge	some
buj	drill
bujer	tree.sp
bujruqt	leave.3s.obj
buk	book.TP
bul	pig
bul	turn
bula	afternoon
buleren	23d.pres.iter?
buloŋna	gift
bun	3p.ss?; 2ns.ds?
buna	dove
buntata	gable.wall
buq	dig
buru	break.TP
buruq	flame
bus	3p.?
busen	3p.prs.dur?
busne	top
busun	3ns.pst.dur?
d	?
d	?
d	bring
d	go; come; go.in; return
d	push
da	sing?; appear; arrive; become
dab	ear
dabagri	ear
dabo	other.side
dabu	shoo; clean.up; get.rid.of
dabu	side
dabuig	remove
dadal	plant.sp
dagaru	crooked
Dagaum	Dagaum
Dagaun	Dagaun
dam	step
damu	inside; intens; true
damu	meat
dan	who?
daqne	daughter
daten	how?
datu	what?
debul	thigh
dei	where
deŋdeŋ	straight
deŋgal	stick
di	where
dib	dusk
diŋgi	dinghy.boat.TP
do	child; son
dodo	little
dokeneŋ	small
dole	near?
Don	Don
dona	bone.tool
doqal	cough; cough
doqe	child.3s.poss
doqone	near?
doru	elongated
dorwa	cold
Doum	Doum
doŋ	break.off
du	body
dub	forest
dubul	transform.into
dug	
dul	vein
dundeqla	girl
duqum	just?
dutagu	body; skin
dutaqu	
dutla	skin
e	2s.imp
e	?
e	hey; eh
e	introduce.quote
e	q
e	q?; eh; emph
e	ser
eben	23ns.fpst
ebib	hurry?
eblan	23d.fpst
egau	ifut?
ele	shoulder; carry
em	2s.rpst/fut; 2s.rpst; 2s.fut; 3s.fut??; 2s.imp?
emen	1s.fpst; 2p.ifut?
emun	1ns.fpst
en	3s.rpst/fut/hab?; 3s.rpst; 3s.fut
en	?
en	?
en	q?
en	take.3s.rpst
enes	Enes.name?
enjiŋ	fat
eo	loc
epol	apple.TP
eq	neg.participle?; pres?
eqen	3s.prs?; prs.perf?
er	??; dur?
erea	area
eren	3s.prs.iter?; 1s.prs.prog?; 3s.prs.perf?
eria	area.TP
eriŋ	avoid
es	irr.ss; 3s.r.ss; irr:opt?
esen	3s.prs.hab
esen	ds.sim?; ss.seq?; ds.seq
eteu	?
etir	look.down
eu	?
eu	hab.aux?; take
ey	?
ey	carry
eñel	angel
eŋgl	count
fam	farm.TP
fama	farmer.TP
femli	family.TP
g	1ns.obj
g	give.to.1p
ga	1pe
ga	be.missing
gaba	carry
gabra	stream
gaga	?; be.angry.at
gagai	uncle
gagali	1de.emph
gagayi	1pe.emph?
gai	uncle
gal	1de
galum	1de.poss
Galupi	Galupi
gam	1pe.poss
Gamaŋ	Gamaŋ
gamba	coconut.shell
gambor	basket
Garagasi	Garagasi
garam	moon
gare	cloth; foreskin
gari	cloth
garijog	set.samting.TP=?
Garim	Garim.place
Gasom	Gasom.person
gate	head; play.war
gaten	aim
gateu	fight
gatuŋ	jump; cloze
gatuŋgu	(magic.word)
gatuŋt	close
gau	avoid
gau	shoot
gavman	government.TP
gaŋgu	wind.fish
ge	digit; fruit
ge	spear
geil	carry
genim	possum
gere	correct
gere	make?
geŋgunti	how.much
gi	?
gig	armpit
gil	?; fly?
gin	come
gineda	arrive
gir	crawl
gitaŋ	stone
gitet	bend
gitetu	give.weight
gogmu	village
gogumu	
gom	path; reason
gom	search
gonim	magic
gor	joint
Gorendu	Gorendu
gour	throw
gu	cook
Guabe	Guabe.place
gugrus	corn
guguji	piece
gujit	
gul	string
Gulom	Gulom
gulumna	rudder
gumbeli	
gumble	husband?
gumbliqa	boy?
Gumbu	Gumbu.place
gurau	tree.sp
guriŋ	shaft
guruŋduŋ	sound.onomat
gute	depth
guñalaŋ	black.cockatoo
gwal	gwal
Gwaŋ	Gwaŋ
ho	hello; so
i	?
i	?
i	dat?
i	give?
i	prox?; loc
iaqen	3s.?
ib	2ns.imp
ibi	?
iboŋ	hand
igobu	pool
Ileg	Ileg
ilit	paint
ilog	westward?; over.there
im	3s.irr?
imbli	semen
imel	email.TP
ina	grass.sp
injalum	23d.poss
injam	23p.poss
injeroq	make?
injoŋ	be.busy
injroq	do.thus.still?
isoŋ	spirit
isroŋu	red
it	caus
it	write
iti	follow
iw	hab?
iŋg	give.to.2p
iŋgi	food
iŋgros	scratch
j	?; have?
jaq	get; take; bring
jaqanam	crayfish
jar	search.through
je	who
jegara	all
jelam	?; firefly
jemble	morning
Jemen	German
Jemeni	Germany
jeram	wrist?
jerau	run.away
jeraw	run; go.separate.ways
jeŋ	sugar
jige	afternoon?
jiglain	k.o.pandanus
jigli	cucumber
jigor	throw; get.rid.of
jim	1s.poss
jiqarqulu	sweet.potato
jir	cordyline
jiw	k.o.pandanus
jog	go.inside; put.inside; put.on
jon	become.wild?
joŋ	flutter.around
ju	make
Jumbu	Jumbu
junum	name
juqa	cassowary
juu	stoke
kabiw	show; teach
kabut	hide; cover.up
kadei	friend
kajir	dirty
Kakara	Dampier
Kaliku	Kaliku
kalu	ugly
kaluŋ	kangal.TP=?
kamanji	game.animal; animal?
kamba	?
kampani	company.TP
Kamu	Kamu
kansol	consul?.TP
kapa	metal.TP
kapo	rooster.onomat
kapsait	capsize.TP
kas	tobacco
kawai	old.person
kaye	thanks
kaŋgere	piece?
kaŋgruŋ	big
kekere	same
Kelsi	Kelsey.person
keneneŋ	little.redup
keneŋ	little
kenjim	penis.head
kere	enough?; all; well.adv
keret	all
Keti	Cathy
keu	Kawa
keŋeneŋ	
kiap	colonial.official.TP
kileŋ	saitim.TP=?
kirapim	awaken.TP
Kiñalbu	Kiñalbu
klia	clear.TP
ko	neck
koken	spill?
kokorla	rooster.onomat
kolektim	collect.TP
kolmen	Coleman.lamp
kompensesen	compensation.TP
kon	swallow; cross
konau	throat
kone	neck
kopra	kopra.bag.TP
Korendu	Gorendu
Korenduk	Gorendu
kosoŋgor	voice
kot	court.TP
koŋkoŋ	Chinese.taro
kriŋa	woman
kroŋgroŋ	frog
ku	go
Kul	Kul
kuli	great.great.grandfather
kuruq	clean
l	wash?
la	?; die?
la	stupid
lagabu	dark
lain	plantation; family.TP
laki	lucky
lala	tail.feather
lalai	slow
lalbul	turn
lalit	leave
Laloq	Lalok.place
lam	lamp.TP
lambe	
lambi	many; long.of.time
laq	hear
laqa	below
laqat	avoid
lat	forget
lata	ladder.TP
laŋ	sky
laŋgu	landward; above
le	kill
les	lazy
lili	with
lo	law.TP
lokim	lock.TP
lola	prayer
m	?
ma	call.out
mablum	flying.fox
Madaŋ	Madang.place
magle	guts; room; inside; belly
magma	mother.in.law
Magret	Margaret.person
makau	cow.TP
makim	mark.TP
maklai	Maklai
mal	tree.sp; loincloth
malain	ainang.TP?
malel	sit
maliŋ	dawn; time
maliŋ keret	always
mam	hungry
mambris	butterfly
man	1s.rpst/fut; 1s.rpst; 1s.fut
man	man.TP
mana	louse
mana	mountain
Managate	Managate.place
managruŋ	nose
maqam	jaw
Maqamsu	Magamsu.place
mar	talk
Maragum	Marakum
mari	carry
Mas	Mas
maski	nevermind
mañim	sister.i.l
maŋamaŋau	various
maŋau	custom; picture; thing
mb	2s.obj; 1pi.obj?
mei	eee
meit	sit.down.caus
Melamu	Malamu
mem	1s.prs; 1s.ifut
mem	father; master?
memba	member.TP
meme	goat
memen	1s.prs.dur?
memes	12s.iter.r.ss?
memori	memorial.TP
meq	2s.prs
meqen	2s.prs.hab
mere	2s.imp.iter?
meren	12s.prs.iter?
mereu	dry.water?
mes	12s.r.ss
mesen	12s.prs.hab
mete	first
mey	sit
mi	talk.to
miliŋ	lightning
milyaqun	brush.turkey
mine	stomach
misil	like
misil	saliva
miŋ	dark
miŋga	rat
mo	die; sick
moab	possum
modar	breath; spirit
modarqa	life?
moen	tongue
moga	banana
mogal	seaward?
Moksen	Moksen
momaki	little.brother?
moman	face
momaŋgamba	forehead
momor	childish
moni	money.TP
moqal	below
moqar	bean
moqolu	below
moro	old
mosne	odor?
moŋdamu	land
moŋgi	coconut
Muar	Muar
mub	mouth
mubolam	mouth
mued	?; this.place?
mulan	1d.rpst
mum	1ns.prs; 1ns.ifut
mumbre	torch
mumun	1ns.prs.dur?
mun	1ns.rpst/fut; 1ns.rpst; 1ns.fut
mun	festival
Mundre	Mindre
mur	1ns.??
muren	1ns.prs.iter?
muru	bulge?
mus	1ns.r.ss
musen	1ns.prs.hab
n	3sg.poss?
n	agt; emph; pat.top; gen?; instr; top
n	carry?
na	and.TP
nabal	time; day
nai	skirt
naji	3p
nal	3d
nal	change
nal	day?
nal	now
nam	2s.poss
nam	2s.poss; 1s.poss?
nambre	bundle
nambu	sister
nambwan	first.TP
name	before; long.time; now?; first; in.front
namediŋ	old
nami	long.time; early
namidiŋ	
namur	fat
nanaji	3p.emph
nanjalum	3d.poss
nanjam	3p.poss
naram	bundle
nareŋ	hornbill
nau	bamboo
nau	now.TP
naŋgli	
naŋglii	
ndam	3s.poss
ndin	?
ndui	alone?
ne	and
ne	see
neba	look.at.1s
neñiqra	trash
neŋgereŋ	school
neŋgreŋ	?; school
neŋgut	cold
Niugini	New.Guinea
niuspepa	newspaper.TP
nj	3ns.obj
njam	23ns.poss
nnn	mmm
nogam	sibling
noi	near
nono	get.close.to
nonoi	small; closeby
noqa	
nuji	island
nuŋgai	alone
o	oh
o	or.TP
o	talk.back
oboq	open
oboqt	open
oda	correct?
ogen	
oho	oho
oj	?
oj	touch
okam	hand.drum
okei	okay
ola	walk; go.around
olam	butt?; inside; hole
olaw	lie.to
ole	long
oler	go.around
olsem	thus
ombor	lid
on	see
opim	open.TP
oq	go.up
oqgin	come.up
oqu	
or	heart
orait	okay.TP
oru	tail
osale	remove; unfold
ot	trip.TP
otaŋgra	place.for.putting.pot
ou	answer
oy	flee
oya	run.away
oyu	butt
oŋ	go
oŋgin	return/come
oŋgo	testicles
padal	die
pag	hide; go.past
pagt	put
palama	k.o.arrow
palim	k.o.pandanus
pam	(onomat.for.flying.fox)
pampum	?
pandiŋ	stand
papai	papaya
paq	spill?
paqariŋ	turn
paqt	pour
pat	stone.axe
paŋ	piece
pepa	paper.TP
peu	try
piksa	picture.TP
pikus	rubber.tree
pil	change
pilim	feel
piliŋ	clear
piqpaq	spill?
piti	kick.out
plantesin	plantation.TP
po	split
polis	police.TP
poloqt	leave.3s.obj
polort	
pom	dip?; flood
popla	open
poq	boil
pot	split
poŋ	clear; break; think?
praimeri	primary
prika	prika.TP
priq	shake
prrqaqad	come.up.on.other.side?
prut	fruit.TP
pu	blow; fall.down
pulu	return
q	obl; dat
qa	chew?; make.right?
qa	color?
qa	top?
qabal	cousin; brother.in.law
qabau	other.side?
qabin	thing
qabineu	Kabineu
qabiŋ	
qabnau	marmot
qaboq	be.full?
qaboqe	full
qabraqu	
qabrawu	dry?
qabul	breadfruit
Qabuŋ	Qabun.person
qadi	also
qaglu	break
qaib	fish
qaigi	sap
qaigi	tooth
qain	mosquito
qaja	fight; police?
qaja	k.o.arrow; spear
qajir	pinch
qajiu	problem
qajoŋ	space
qal	shoot; break; pour; slaughter
qal	thunder?
qale	food?
qali	know
qalu	night; darkness
qalue	female?
qalupti	three
qaly	
qam	smoke
qamag	net/web
qambu	unite
qanam	top?
qanaqum	tree.sp
qani	true
qanjurum	longmouth.fish
qanun	shadow; spirit
qapou	?
qaqai	neg
qaqal	hit; look; found
qaqali	look
qaqam	moon
qaqane	only?
qaqein	prayer
qaql	hit
qaqun	basket
qar	fence
qarqos	block
qasa	lie.giaman
qasan	hurry
qasañe	quickly
qaseŋ	tool
qataŋ	bite
qau	betelnut
qaubi	white
qaugogo	I.like.it
qaun	push; swim
qauwai	travel
qawal	tree.sp
qawe	new
qayaqun	tree.sp
qayer	blood
qaŋ	pull; row.a.boat
qaŋgl	wander; stay
qe	plan?
qei	3s?
qei	butt?/thing?
qei	what; thing
qeij	cockatoo
qeil	decoration
qelagu	young
qemor	children
qeu	do.thus?
qi	
qimbi qambariŋ	cranky
qo	chop
qobu	pond
qobul	widow
qobuŋ	canoe
qoki	bird.sp
qom	fog
qombi	fog
qoqobroq	break.redup?
qoqol	chase.out?
qoqolain	tree.sp
qoqoleti	four
qoqoros	firefly
qoraŋ	small.intestine?
qoro	back
qos	fasten
qosiw	wrist?
Qotoi	God
qoul	fence.in
qouna	old
qu	fill?
qu	go
qu	loc
quji	
quji	one; together; same; with
qul	bowstring
qul	go.down
qulat	boss; watch.out.for
qulgin	come.down
quli	hide
qulumna	paddle
qun	bag
qundi	pl?
qur	cut
qurat	finish
Qurenduk	
quribi	with; all; together
quriŋ	handle
qurrurru	Kurrurru.place
Qururu	Kururu
qusawu	wet
quse	body
qut	with.comitative; together; agt?; dat?
qutu	shake
qutuluŋ	be.frightened
qwain	left.arm
raba	rubber.TP
Raikos	Rai.Coast
rait	right?.TP
rar	game
raruŋgamba	leak.water
rasia	Russia
Rasian	Russian
rau	wall
rausim	get.rid.of.TP
raŋ	parent.in.law
resis	race.TP
reŋ	nmzr?
rum	room.TP
Rumbau	Rumbau
s	?
sa	dog
sa	return.to?; go
sabuk	be.angry
sabuqti	stupid?
sagiu	armband
sain	?
sait	site.TP
saman	outrigger.TP
samba	leg
sambi	yam
sambun	wait
sande	Sunday.TP
sapor	axe
sapos	if.TP
saqarum	stone
saqau	greens; multi.prong.arrow
saqau ge	k.o.arrow
saqre	tall
sare	old
sare	testicles
sasam	shark
sasawa	all?
Satan	Satan.Eng
sau	?
Saul	Saul
saw	go
sawa	sea.TP; village?
sawe	know.TP
sawe	there
saŋal	crab
saŋgaŋ	watch.out.for
saŋgeleŋ	dry
se	empty?
sel	vine
sel dul	phone (vine vein)
sem	?
sen	dur
sen	toward?
sena	taro
senaqal	boil
serereq	sizzle
sevi	think
si	?
si	be; sit; stay; have
si	nail
sibol	wallaby
sin	instr?
sirau	knife
Siroi	Siroi
sisi	be.hab?
sisi	news
sisiu	personal.information?; state.of.being
siw	laugh
siwoni	fruit.sp
siŋ	sun
skul	school
sogal	far
sombrom	tail
soq	lift
soqam	stick?
soqol	breadfruit.egg?
soqu	open
sore	sorry
Soŋgum	Songum
stori	story
sub	hole; place?
sub	old?
sub	push.TP
suga	sugar.TP
sumbi	black
sumbiŋ	flute
sumbli	small
suqle	bone
sur	fall.down
surmai	fish.sp
sururuq	stand.on.top?
susu	afraid?
suu	serve.food; accompany
suw	take.away
suŋgli	baby
ta	dance?
tabar	village; foreign
tabir	plate; money; bowl
tag	fetch
tag	fill.up; scoop
tag	tie
taia	tire.TP
taim	time
tal	house
tambram	source?
tambriŋ	afraid?; fear
tamo	man
tamtar	others?
Tapaŋbi	Tapangbi
tapor	iron.axe
taqel	bend; walk?
tar	lie.on.back
tar	up?; put.up
tartiu	turn
tasol	but
tat	do.what
tatal	not.know
tatawe	party?
tater	take.out
tatruye	throw?
tatu	awaken
taul	egg
Taulem	Taulem
tavir	chest
tavre	chest
tawel	towel
tawi	loincloth
taŋ	collect
taŋar	father.in.law
taŋgu	(magic.word)
taŋy	too.much?
tem	
temur	wind
tenem	straight; very
tenemte	?; correct
tenemu	straight
tenenem	quiet; straight
tenkyu	thank.you.TP
tera	
teta	ladder
tf	disfluency
ti	emph?
timbaŋ	hold.fast
tinau	mainland
tir	?; land
tira	now?; go.ashore
Tok Pisin	Tok Pisin
tom	3s.poss?
tom	hold; try
toran	ask
torom	help
toror	encounter
tot	same
totoum	picture
toum	hold?
toum	picture
tour	meet
toura	sail
Toya	Toya
tra	pl
trausel	turtle.TP
tu	chicken
tu	too.TP
Tuag	Tuag
Tui	Tui
tumbaŋ	carry
tumbuna	old.TP
Tumbuqolom	Tumbuqolom
tuq	capsize
tutu	move
tutut	push
tuŋu	make
u	aux?
u	eat
u	nmzr?
u	penis
u	put; throw
ubu	stone; height
ubutaun	roof.beam
ugle	intestine
uja	digging.stick
ujagla	navel
ul	get.up
uleo	beach
uleu	shore
uli	feathers
uli	hide
ulul	sand
um	loc?
umbuq	fall.down
und	that
undi	other.side?
unj	give.to.3p
uqole	heavy
uqule	problem; weight
ur	3s.obj?; ?
uru	fly
uru	tie
urur	capsize
usul	shake
utre	stump; way; kind; owner?; reason?
utri	platform?; under
utu	help
utu	piece?; remainder
utua	adopt
uy	give.to.3p; give.to.3s
video	video.Eng
w	make
wa	yes
wab	kneecap
wab	pot
wal	sea
wali	friend
walu	pumpkin
war	k.o.pandanus
wau	garden; work; field
wau	grandfather; grandchild
wawasa	ancestor
waya	crocodile
wayaŋ	yell
Waŋ	Wang
weipa	get.up
wemun	clan
wes	urine
wi	hurt
wi	lime; ashes
wibi	?
wilwil	bicycle.TP
win	turtle
wiqna	story; spirit/ghost
wisil	weasel?.TP
wula	wake.up
wuleu	sand?
wulqot	dream
wur	finish
yab	yesterday
Yabob	Yabob
Yabui	Yabui
yaiŋ	
yal	1di
Yalo	Yalo
yalum	1di.poss
yamba	tomorrow
Yambambu	Yambambu.snake
yamban	bush
yar	year.TP
yau	be.hot
yau	betel.pepper
yau	take
yaulbi	yellow
yaw	burn
yawan	tree.sp
yaya	send
yayali	1di.emph
yekram	bug.sp
yesus	Jesus
yi	move?
yi	water; beer
yib	?
yig	1pi
yigum	1pi.poss
yil	bathe
yit	chase
yiyigi	1pi.emph?
yobu	quietly
Yomba	Jomba
you	sore
your	k.o.spear
yu	?
yu	?
ñ	sleep
ñaro	trash?
ñe	lay.down
ñeu	scratch
ñeñik	fly
ñi	2s
ñij	2p
ñil	2d
ñiñiji	2p.emph
ñiñili	2d.emph
ñiñiyi	2s.emph
ñuqulam	leg.mark?
ŋ	
ŋalom	place?
ŋam	eye; look.for
ŋamgi	eye
ŋamku	lie.face.down
ŋamqabut	?
ŋamqu	?
ŋaram	cover.up; bundle
ŋariŋ	hot
ŋarog	eastward?; over.there?
ŋaŋai	aunt
ŋaŋgli	woman
ŋele	husk
ŋelik	brain
ŋg	2ns.obj
ŋil	vomit
ŋis	sweat
ŋis	wash
ŋoqa	wife.3s.poss
ŋuq	peel
ŋwaŋ	brush.turkey
